"aa" = (/turf/space,/area/space)
"ab" = (/turf/space,/turf/simulated/shuttle/wall{dir = 8; icon_state = "diagonalWall3"},/area/space)
"ac" = (/turf/simulated/shuttle/wall{icon_state = "wall3"},/area/space)
"ad" = (/turf/space,/turf/simulated/shuttle/wall{dir = 1; icon_state = "diagonalWall3"},/area/space)
"ae" = (/turf/simulated/floor/plating/airless,/area/space)
"af" = (/obj/effect/decal/cleanable/blood/gibs,/turf/simulated/floor/plating/airless,/area/space)
"ag" = (/obj/structure/lattice,/turf/space,/area/space)
"ah" = (/obj/machinery/door/airlock/centcom,/turf/simulated/floor/plating/airless,/area/space)
"ai" = (/obj/item/weapon/shard,/turf/space,/area/space)
"aj" = (/obj/structure/curtain/open/shower,/obj/machinery/shower{icon_state = "shower"; dir = 4},/obj/machinery/light{dir = 1},/turf/simulated/floor/plating/airless,/area/space)
"ak" = (/obj/structure/curtain/open/shower,/obj/machinery/shower{icon_state = "shower"; dir = 8},/obj/item/weapon/paper/crumpled/bloody{info = "I fucking told cappie that we shouldn't have flown too close to that big ship! Now we're all dead!"; name = "note"},/turf/simulated/floor/plating/airless,/area/space)
"al" = (/obj/structure/grille,/obj/structure/window/reinforced{dir = 1},/obj/structure/window/reinforced{dir = 4},/obj/structure/window/reinforced{dir = 8},/turf/simulated/shuttle/plating,/area/space)
"am" = (/obj/item/weapon/shard{icon_state = "small"},/turf/space,/area/space)
"an" = (/obj/structure/toilet{dir = 4},/obj/effect/decal/cleanable/blood,/turf/simulated/floor/plating/airless,/area/space)
"ao" = (/obj/effect/decal/remains/human,/turf/simulated/floor/plating/airless,/area/space)
"ap" = (/obj/structure/grille,/obj/structure/window/reinforced{dir = 4},/obj/structure/window/reinforced{dir = 8},/turf/simulated/shuttle/plating,/area/space)
"aq" = (/obj/machinery/light{dir = 4},/turf/simulated/floor/plating/airless,/area/space)
"ar" = (/obj/machinery/atmospherics/pipe/simple/hidden/supply,/obj/machinery/door/airlock/centcom,/turf/simulated/floor/plating/airless,/area/space)
"as" = (/obj/structure/grille,/obj/structure/window/reinforced,/obj/structure/window/reinforced{dir = 4},/obj/structure/window/reinforced{dir = 8},/turf/simulated/shuttle/plating,/area/space)
"at" = (/obj/machinery/cryopod/right,/turf/simulated/floor/plating/airless,/area/space)
"au" = (/obj/structure/cable{d1 = 4; d2 = 8; icon_state = "4-8"},/obj/machinery/door/airlock/centcom,/turf/simulated/floor/plating/airless,/area/space)
"av" = (/obj/structure/bed/chair/shuttle{tag = "icon-chair3 (WEST)"; icon_state = "chair3"; dir = 8},/turf/space,/area/space)
"aw" = (/obj/structure/table,/obj/machinery/microwave,/turf/simulated/floor/plating/airless,/area/space)
"ax" = (/obj/structure/bed/chair/shuttle,/turf/simulated/floor/plating/airless,/area/space)
"ay" = (/turf/space,/turf/simulated/shuttle/wall{icon_state = "diagonalWall3"},/area/space)
"az" = (/obj/structure/table,/obj/item/weapon/storage/box/donkpockets,/turf/simulated/floor/plating/airless,/area/space)
"aA" = (/obj/item/weapon/shard{icon_state = "medium"},/turf/space,/area/space)
"aB" = (/obj/structure/table/rack,/obj/random/toolbox,/obj/random/tool,/turf/simulated/floor/plating/airless{tag = "icon-warnplate (NORTHEAST)"; icon_state = "warnplate"; dir = 5},/area/space)
"aC" = (/obj/structure/bed/chair/shuttle{tag = "icon-chair3 (NORTH)"; icon_state = "chair3"; dir = 1},/turf/simulated/floor/plating/airless,/area/space)
"aD" = (/obj/structure/table/rack,/obj/random/tech_supply,/obj/random/tech_supply,/turf/simulated/floor/plating/airless{tag = "icon-warnplate (EAST)"; icon_state = "warnplate"; dir = 4},/area/space)
"aE" = (/turf/space,/turf/simulated/shuttle/wall{dir = 4; icon_state = "diagonalWall3"},/area/space)
"aF" = (/obj/structure/closet/crate,/obj/item/stack/sheet/mineral/phoron,/obj/item/stack/sheet/mineral/phoron,/obj/item/stack/sheet/mineral/phoron,/obj/item/stack/sheet/mineral/phoron,/obj/item/stack/sheet/mineral/phoron,/obj/item/stack/sheet/mineral/phoron,/obj/item/stack/sheet/mineral/phoron,/obj/item/stack/sheet/mineral/phoron,/turf/simulated/floor/plating/airless{tag = "icon-warnplate (NORTHWEST)"; icon_state = "warnplate"; dir = 9},/area/space)
"aG" = (/obj/structure/grille,/obj/structure/window/reinforced,/obj/structure/window/reinforced{dir = 1},/obj/structure/window/reinforced{tag = "icon-rwindow (WEST)"; icon_state = "rwindow"; dir = 8},/turf/simulated/shuttle/plating,/area/space)
"aH" = (/obj/structure/window/reinforced,/obj/structure/grille{density = 0; icon_state = "brokengrille"},/turf/simulated/shuttle/plating,/area/space)
"aI" = (/obj/structure/grille{density = 0; icon_state = "brokengrille"},/turf/simulated/shuttle/plating,/area/space)
"aJ" = (/obj/structure/closet/crate/medical,/obj/machinery/light{dir = 8; icon_state = "tube1"; pixel_y = 0},/obj/item/weapon/storage/firstaid,/obj/item/weapon/storage/firstaid/adv,/obj/item/weapon/storage/firstaid/fire,/obj/item/weapon/storage/firstaid/o2,/obj/item/weapon/storage/firstaid/toxin,/turf/simulated/floor/plating/airless{tag = "icon-warnplate (EAST)"; icon_state = "warnplate"; dir = 4},/area/space)
"aK" = (/obj/structure/closet/crate,/obj/item/clothing/head/collectable/beret,/turf/simulated/floor/plating/airless{tag = "icon-warnplate (WEST)"; icon_state = "warnplate"; dir = 8},/area/space)
"aL" = (/turf/simulated/shuttle/plating,/area/space)
"aM" = (/obj/structure/closet,/turf/simulated/floor/plating/airless{tag = "icon-warnplate (SOUTHEAST)"; icon_state = "warnplate"; dir = 6},/area/space)
"aN" = (/turf/simulated/floor/plating,/area/space)
"aO" = (/turf/simulated/floor/plating{icon_state = "warnplate"; dir = 4},/area/space)
"aP" = (/obj/structure/ore_box,/obj/machinery/light{dir = 4; icon_state = "tube1"},/turf/simulated/floor/plating/airless{tag = "icon-warnplate (WEST)"; icon_state = "warnplate"; dir = 8},/area/space)
"aQ" = (/obj/structure/bed/chair/shuttle{tag = "icon-chair3 (NORTH)"; icon_state = "chair3"; dir = 1},/obj/machinery/light,/turf/simulated/shuttle/plating,/area/space)
"aR" = (/obj/structure/bed/chair/shuttle{tag = "icon-chair3 (NORTH)"; icon_state = "chair3"; dir = 1},/turf/simulated/shuttle/plating,/area/space)
"aS" = (/turf/simulated/floor/plating{icon_state = "warnplate"; dir = 8},/area/space)
"aT" = (/obj/structure/closet,/turf/simulated/floor/plating/airless{tag = "icon-warnplate (SOUTHWEST)"; icon_state = "warnplate"; dir = 10},/area/space)
"aU" = (/obj/machinery/door/airlock/centcom,/obj/machinery/atmospherics/pipe/simple/hidden/supply,/obj/structure/cable{d1 = 1; d2 = 2; icon_state = "1-2"},/turf/simulated/shuttle/plating,/area/space)
"aV" = (/obj/machinery/light{dir = 1},/turf/simulated/floor/plating/airless,/area/space)
"aW" = (/obj/machinery/optable,/turf/simulated/floor/plating/airless,/area/space)
"aX" = (/obj/machinery/computer/operating,/turf/simulated/floor/plating/airless,/area/space)
"aY" = (/obj/effect/decal/cleanable/blood,/turf/simulated/floor/plating/airless,/area/space)
"aZ" = (/obj/structure/table,/obj/machinery/light{tag = "icon-tube1 (NORTH)"; icon_state = "tube1"; dir = 1},/obj/item/weapon/storage/surgery_bag,/turf/simulated/floor/plating/airless,/area/space)
"ba" = (/obj/structure/shuttle/engine/heater,/turf/simulated/shuttle/wall{icon_state = "wall3"},/area/space)
"bb" = (/obj/item/weapon/storage/firstaid,/obj/structure/table,/turf/simulated/floor/plating/airless,/area/space)
"bc" = (/obj/structure/shuttle/engine/propulsion,/turf/space,/area/space)
"bd" = (/obj/machinery/sleeper{icon_state = "sleeper_0-r"; orient = "RIGHT"},/turf/simulated/floor/plating/airless,/area/space)
"be" = (/obj/machinery/sleep_console,/turf/simulated/floor/plating/airless,/area/space)
"bf" = (/obj/structure/table,/obj/item/seeds/random,/obj/item/seeds/random,/obj/item/seeds/random,/obj/item/weapon/hatchet,/obj/item/weapon/minihoe,/obj/item/weapon/shovel/spade,/turf/simulated/floor/plating/airless,/area/space)
"bg" = (/obj/structure/closet/secure_closet/freezer/meat,/turf/simulated/floor/plating/airless,/area/space)
"bh" = (/obj/structure/grille,/obj/structure/window/reinforced{dir = 1},/obj/structure/window/reinforced,/obj/structure/window/reinforced{dir = 4},/turf/simulated/shuttle/plating,/area/space)
"bi" = (/obj/machinery/light{tag = "icon-tube1 (NORTH)"; icon_state = "tube1"; dir = 1},/obj/machinery/seed_extractor,/turf/simulated/floor/plating/airless,/area/space)
"bj" = (/obj/structure/reagent_dispensers/watertank,/obj/item/weapon/reagent_containers/glass/bucket,/turf/simulated/floor/plating/airless,/area/space)
"bk" = (/obj/machinery/vending/hydronutrients,/turf/simulated/floor/plating/airless,/area/space)
"bl" = (/obj/machinery/portable_atmospherics/hydroponics,/turf/simulated/floor/plating/airless,/area/space)
"bm" = (/obj/structure/grille,/obj/structure/window/reinforced{dir = 1},/obj/structure/window/reinforced,/turf/simulated/shuttle/plating,/area/space)
"bn" = (/obj/structure/window/reinforced{dir = 1},/obj/structure/grille{density = 0; icon_state = "brokengrille"},/turf/simulated/shuttle/plating,/area/space)

(1,1,1) = {"
aaabacacadaaaaaaaaaaaaaaaaaaaaaaaaaaaaaaaaaa
aaacaeaeacaaaaaaaaaaaaaaaaaaaaaaaaaaaaaaaaaa
aaacafaeacaaaaagaaaaaaaaaaaaaaaaabacacadaaaa
abacahacacaaaaaaaaaaaaaiaaagaaaiacajakacaaaa
alaeaeaeacaaaaaaaaamaaaaagaaaaaaacanaoacaaaa
apaeaqacacagaaaaaaaaaaaaaaaaaaaaacacaracadaa
asataeauaeagaaaaagagaaaaavaaaaaaacawaeaxacaa
ayacagaaagaaaaaaaaagaaaaaaaaabacacacaeazacaa
aaaaaaaaaaaaaaaiaaaaaaaAaaaaacaBaeahaeaCacaa
aaaaaaaaaaaaaaacadaaaaaaaaaaacaDaeacacacaEaa
aaaaaaagaaaaagaFacaGaHaIaaaaacaJaeaeaeaeaaaa
aaaaaaagagagagaKacaLaLaLaaaaacaMaeaeagagagaa
aaaaagagaNaOaeaPacaQaLaRaaaeaeaeaeagagaaaaaa
aaaaagaSaNaOaeaTacacaUacaaaaagagaaagaaaaaaaa
aaaaabacacacaeaeaeaVaeaeaaagaaaaaaaaaaaaaaaa
aaaaacaWaXacahacaeaeaeagaaaaaaaaaaagaaaaaaaa
aaaaacaYaYaZaeacbabaacagaaagaaagagagagaaaaai
aaaaaabbaeaYaeacbcbcaaaaaaagaeaeaeacacacadaa
aaaaaaaabdbeaeacaaaaaaaaagaeaeacahacbfbgacaa
aaaaagaaaIaHbhaEaaaaaiaaaababaacaebiaeaeacaa
aaaaaaaaaaaaaaaaaaaaaaaaaabcbcacaeaYafbjacaa
aaaaaaaaaaaaaaaaaaagaaaaaaaaaaacbkblblacaEaa
aaaaaaaaaaaaaaagaaaaaaaaaaaaaaaybmbnbhaEaaaa
"}
