"aa" = (/turf/space,/area/space)
"ab" = (/turf/simulated/mineral,/area/space)
"ac" = (/turf/simulated/floor/plating/airless/asteroid,/area/space)
"ad" = (/obj/effect/decal/cleanable/blood,/turf/simulated/floor/plating/airless/asteroid,/area/space)
"ae" = (/obj/effect/decal/cleanable/blood/gibs/core,/turf/simulated/floor/plating/airless/asteroid,/area/space)
"af" = (/mob/living/simple_animal/hostile/bear,/turf/simulated/floor/plating/airless/asteroid,/area/space)
"ag" = (/obj/effect/decal/cleanable/blood/gibs/body,/turf/simulated/floor/plating/airless/asteroid,/area/space)
"ah" = (/obj/effect/decal/cleanable/blood/gibs/robot/limb,/turf/simulated/floor/plating/airless/asteroid,/area/space)
"ai" = (/turf/space,/turf/simulated/shuttle/wall{dir = 8; icon_state = "diagonalWall3"},/area/space)
"aj" = (/turf/simulated/shuttle/wall{icon_state = "wall3"},/area/space)
"ak" = (/turf/simulated/floor/plating/airless/asteroid,/turf/simulated/shuttle/wall{dir = 1; icon_state = "diagonalWall3"},/area/space)
"al" = (/obj/effect/decal/cleanable/blood/splatter,/turf/simulated/floor/plating/airless/asteroid,/area/space)
"am" = (/obj/effect/gibspawner/human,/turf/simulated/floor/plating/airless/asteroid,/area/space)
"an" = (/obj/machinery/atmospherics/pipe/simple/visible{icon_state = "intact"; dir = 6},/turf/simulated/floor{icon_state = "dark"},/area/space)
"ao" = (/obj/machinery/atmospherics/pipe/tank/air{dir = 8; volume = 10},/turf/simulated/floor{icon_state = "dark"},/area/space)
"ap" = (/obj/structure/table,/turf/simulated/floor/plating/airless/asteroid,/area/space)
"aq" = (/obj/machinery/atmospherics/pipe/simple/visible/universal,/obj/structure/cable{d2 = 2; icon_state = "0-2"; pixel_y = 0},/turf/simulated/floor{icon_state = "dark"},/area/space)
"ar" = (/turf/simulated/floor{icon_state = "dark"},/area/space)
"as" = (/obj/item/weapon/shard,/turf/simulated/floor/plating/airless/asteroid,/area/space)
"at" = (/obj/machinery/floodlight,/turf/simulated/floor/plating/airless/asteroid,/area/space)
"au" = (/obj/machinery/atmospherics/pipe/simple/hidden/supply,/obj/structure/cable{d1 = 1; d2 = 2; icon_state = "1-2"},/obj/machinery/door/airlock/centcom,/turf/simulated/floor/wood,/area/space)
"av" = (/obj/item/stack/rods,/turf/simulated/floor/plating/airless/asteroid,/area/space)
"aw" = (/obj/effect/decal/cleanable/blood/drip,/turf/simulated/floor/plating/airless/asteroid,/area/space)
"ax" = (/obj/effect/decal/remains/human,/turf/simulated/floor/plating/airless/asteroid,/area/space)
"ay" = (/obj/structure/bed/chair/wood,/turf/simulated/floor/wood,/area/space)
"az" = (/obj/machinery/atmospherics/pipe/manifold/hidden/supply{dir = 8},/obj/structure/cable{d1 = 1; d2 = 2; icon_state = "1-2"},/turf/simulated/floor/wood,/area/space)
"aA" = (/obj/structure/bookcase,/obj/machinery/atmospherics/unary/vent_pump{dir = 8; external_pressure_bound = 140; external_pressure_bound_default = 140; icon_state = "map_vent_out"; use_power = 1; pressure_checks = 0; pressure_checks_default = 0},/turf/simulated/floor/wood,/area/space)
"aB" = (/obj/machinery/atmospherics/unary/vent_pump{dir = 4; icon_state = "map_vent_out"; use_power = 1},/turf/simulated/floor/airless,/area/space)
"aC" = (/obj/machinery/atmospherics/pipe/manifold/hidden/supply{dir = 4},/obj/structure/cable{d1 = 2; d2 = 4; icon_state = "2-4"},/turf/simulated/floor/airless{icon_state = "damaged2"},/area/space)
"aD" = (/obj/structure/table/woodentable,/turf/simulated/floor/wood,/area/space)
"aE" = (/obj/machinery/atmospherics/pipe/simple/hidden/supply,/obj/machinery/light{dir = 4; icon_state = "tube1"},/obj/structure/cable{d1 = 1; d2 = 2; icon_state = "1-2"},/turf/simulated/floor/wood,/area/space)
"aF" = (/turf/simulated/floor/plating/airless/asteroid,/turf/simulated/shuttle/wall{dir = 8; icon_state = "diagonalWall3"},/area/space)
"aG" = (/obj/machinery/atmospherics/pipe/simple/hidden/supply,/obj/machinery/light{dir = 8; icon_state = "tube1"; pixel_y = 0},/obj/structure/cable{d1 = 2; d2 = 4; icon_state = "2-4"},/obj/structure/cable{d1 = 1; d2 = 2; icon_state = "1-2"},/turf/simulated/floor/airless{icon_state = "floorscorched1"},/area/space)
"aH" = (/obj/machinery/cryopod,/obj/structure/cable{d2 = 8; icon_state = "0-8"},/turf/simulated/floor/airless,/area/space)
"aI" = (/obj/structure/bed/chair/wood{dir = 1},/turf/simulated/floor/wood,/area/space)
"aJ" = (/obj/machinery/atmospherics/pipe/simple/hidden/supply{dir = 5},/obj/structure/cable{d1 = 1; d2 = 4; icon_state = "1-4"},/obj/effect/decal/cleanable/blood/drip,/turf/simulated/floor/wood,/area/space)
"aK" = (/obj/machinery/atmospherics/pipe/simple/hidden/supply{dir = 4; icon_state = "intact-supply"; tag = "icon-intact (EAST)"},/obj/structure/cable{d1 = 4; d2 = 8; icon_state = "4-8"},/obj/machinery/door/airlock/centcom,/turf/simulated/floor/wood,/area/space)
"aL" = (/obj/machinery/atmospherics/pipe/simple/hidden/supply{dir = 10},/obj/structure/cable{d1 = 2; d2 = 8; icon_state = "2-8"},/turf/simulated/floor/airless,/area/space)
"aM" = (/obj/structure/closet/crate,/turf/simulated/floor/airless{dir = 9; icon_state = "warning"},/area/space)
"aN" = (/obj/structure/grille,/obj/structure/window/reinforced,/turf/simulated/floor/plating/airless/asteroid,/area/space)
"aO" = (/obj/item/stack/rods,/obj/structure/grille{density = 0; icon_state = "brokengrille"},/turf/simulated/floor/plating/airless/asteroid,/area/space)
"aP" = (/obj/item/weapon/shard,/obj/structure/grille{density = 0; icon_state = "brokengrille"},/turf/simulated/floor/plating/airless/asteroid,/area/space)
"aQ" = (/obj/structure/table/rack,/obj/random/tool,/turf/simulated/floor/airless{dir = 5; icon_state = "warning"},/area/space)
"aR" = (/obj/random/toolbox,/obj/structure/cable{d1 = 2; d2 = 4; icon_state = "2-4"},/obj/machinery/atmospherics/pipe/simple/hidden/supply{dir = 6},/turf/simulated/floor/airless{icon_state = "floorscorched1"},/area/space)
"aS" = (/obj/machinery/atmospherics/pipe/simple/hidden/supply{dir = 4; icon_state = "intact-supply"; tag = "icon-intact (EAST)"},/obj/structure/cable{d1 = 4; d2 = 8; icon_state = "4-8"},/obj/machinery/door/airlock/centcom,/turf/simulated/floor/airless,/area/space)
"aT" = (/obj/machinery/atmospherics/pipe/simple/hidden/supply{dir = 9},/obj/structure/cable{d1 = 1; d2 = 8; icon_state = "1-8"},/obj/structure/cable{d1 = 4; d2 = 8; icon_state = "4-8"},/turf/simulated/floor/airless,/area/space)
"aU" = (/obj/structure/cable{d2 = 8; icon_state = "0-8"},/turf/simulated/floor/airless{icon_state = "damaged2"},/area/space)
"aV" = (/turf/space,/turf/simulated/shuttle/wall{icon_state = "diagonalWall3"},/area/space)
"aW" = (/obj/machinery/atmospherics/pipe/simple/hidden/supply,/obj/structure/cable{d1 = 1; d2 = 2; icon_state = "1-2"},/turf/simulated/floor/airless{icon_state = "floorscorched1"},/area/space)
"aX" = (/turf/simulated/floor/airless{dir = 8; icon_state = "warning"},/area/space)
"aY" = (/obj/machinery/computer/shuttle,/obj/structure/cable{icon_state = "0-4"; d2 = 4},/turf/simulated/floor/airless,/area/space)
"aZ" = (/obj/structure/cable{d1 = 2; d2 = 8; icon_state = "2-8"},/obj/structure/cable{d1 = 2; d2 = 4; icon_state = "2-4"},/obj/effect/decal/cleanable/blood/splatter,/turf/simulated/floor/airless,/area/space)
"ba" = (/obj/machinery/computer/shuttle_control,/obj/structure/cable{d2 = 8; icon_state = "0-8"},/turf/simulated/floor/airless,/area/space)
"bb" = (/obj/structure/table/rack,/obj/random/tech_supply,/obj/random/tech_supply,/turf/simulated/floor/airless{dir = 4; icon_state = "warning"},/area/space)
"bc" = (/obj/machinery/atmospherics/pipe/simple/hidden/supply,/obj/structure/cable{d1 = 1; d2 = 2; icon_state = "1-2"},/obj/structure/closet/crate/medical,/turf/simulated/floor/airless,/area/space)
"bd" = (/obj/structure/grille,/obj/structure/window/reinforced{tag = "icon-rwindow (WEST)"; icon_state = "rwindow"; dir = 8},/obj/structure/window/reinforced{dir = 1},/obj/structure/window/reinforced,/obj/structure/window/reinforced{dir = 4},/turf/simulated/floor/plating{icon_state = "warnplate"; dir = 8},/area/space)
"be" = (/obj/machinery/atmospherics/unary/vent_pump{dir = 4; icon_state = "map_vent_out"; use_power = 1},/obj/machinery/light{dir = 1},/turf/simulated/floor/plating,/area/space)
"bf" = (/obj/structure/grille,/obj/machinery/atmospherics/pipe/simple/hidden/supply{dir = 4; icon_state = "intact-supply"; tag = "icon-intact (EAST)"},/obj/structure/window/reinforced{tag = "icon-rwindow (WEST)"; icon_state = "rwindow"; dir = 8},/obj/structure/window/reinforced{dir = 1},/obj/structure/window/reinforced,/obj/structure/window/reinforced{dir = 4},/turf/simulated/floor/plating{icon_state = "warnplate"; dir = 4},/area/space)
"bg" = (/obj/machinery/atmospherics/pipe/manifold/hidden/supply{dir = 4},/obj/structure/cable{d1 = 1; d2 = 2; icon_state = "1-2"},/turf/simulated/floor/airless,/area/space)
"bh" = (/obj/structure/ore_box,/obj/machinery/light{dir = 4; icon_state = "tube1"},/turf/simulated/floor/airless{dir = 8; icon_state = "warning"},/area/space)
"bi" = (/obj/structure/bed/chair/shuttle{tag = "icon-chair3 (NORTH)"; icon_state = "chair3"; dir = 1},/obj/machinery/light,/turf/simulated/floor/airless,/area/space)
"bj" = (/obj/machinery/atmospherics/unary/vent_pump{dir = 2; external_pressure_bound = 140; external_pressure_bound_default = 140; icon_state = "map_vent_out"; pressure_checks = 0; pressure_checks_default = 0; use_power = 1},/obj/structure/cable{d1 = 1; d2 = 2; icon_state = "1-2"},/turf/simulated/floor/airless,/area/space)
"bk" = (/obj/structure/bed/chair/shuttle{tag = "icon-chair3 (NORTH)"; icon_state = "chair3"; dir = 1},/obj/machinery/light,/obj/effect/decal/cleanable/blood/splatter,/turf/simulated/floor/airless,/area/space)
"bl" = (/obj/machinery/light{dir = 8; icon_state = "tube1"; pixel_y = 0},/turf/simulated/floor/airless{dir = 4; icon_state = "warning"},/area/space)
"bm" = (/obj/machinery/atmospherics/pipe/manifold/hidden/supply{dir = 8},/obj/structure/cable{d1 = 1; d2 = 2; icon_state = "1-2"},/turf/simulated/floor/airless{icon_state = "damaged2"},/area/space)
"bn" = (/obj/structure/grille,/obj/machinery/atmospherics/pipe/simple/hidden/supply{dir = 4; icon_state = "intact-supply"; tag = "icon-intact (EAST)"},/obj/structure/window/reinforced{tag = "icon-rwindow (WEST)"; icon_state = "rwindow"; dir = 8},/obj/structure/window/reinforced{dir = 1},/obj/item/weapon/shard,/obj/item/weapon/shard,/turf/simulated/floor/plating{icon_state = "warnplate"; dir = 8},/area/space)
"bo" = (/obj/machinery/atmospherics/unary/vent_pump{dir = 8; external_pressure_bound = 140; external_pressure_bound_default = 140; icon_state = "map_vent_out"; use_power = 1; pressure_checks = 0; pressure_checks_default = 0},/obj/machinery/light{dir = 1},/obj/item/weapon/shard,/turf/simulated/floor/plating,/area/space)
"bp" = (/obj/item/stack/rods,/obj/structure/grille{density = 0; icon_state = "brokengrille"},/turf/simulated/floor/plating{icon_state = "warnplate"; dir = 4},/area/space)
"bq" = (/obj/effect/decal/cleanable/blood/tracks/footprints,/turf/simulated/floor/plating/airless/asteroid,/area/space)
"br" = (/obj/machinery/door/airlock/external,/turf/simulated/floor/plating{icon_state = "warnplate"; dir = 8},/area/space)
"bs" = (/turf/simulated/floor/plating,/area/space)
"bt" = (/obj/machinery/door/airlock/external,/turf/simulated/floor/plating{icon_state = "warnplate"; dir = 4},/area/space)
"bu" = (/obj/machinery/atmospherics/pipe/simple/hidden/supply,/obj/structure/cable{d1 = 1; d2 = 2; icon_state = "1-2"},/obj/effect/decal/cleanable/blood/drip,/turf/simulated/floor/airless{icon_state = "damaged2"},/area/space)
"bv" = (/obj/structure/closet,/turf/simulated/floor/airless{dir = 10; icon_state = "warning"},/area/space)
"bw" = (/obj/machinery/door/airlock/centcom,/obj/machinery/atmospherics/pipe/simple/hidden/supply,/obj/structure/cable{d1 = 1; d2 = 2; icon_state = "1-2"},/turf/simulated/floor/airless,/area/space)
"bx" = (/obj/structure/closet,/turf/simulated/floor/airless{dir = 6; icon_state = "warning"},/area/space)
"by" = (/obj/machinery/atmospherics/pipe/simple/hidden/supply,/obj/structure/cable{d1 = 1; d2 = 2; icon_state = "1-2"},/obj/effect/decal/cleanable/blood/tracks/footprints,/obj/effect/decal/cleanable/blood/tracks/footprints,/turf/simulated/floor/airless,/area/space)
"bz" = (/obj/machinery/door/airlock/external,/obj/effect/decal/cleanable/blood/tracks/footprints,/turf/simulated/floor/plating{icon_state = "warnplate"; dir = 8},/area/space)
"bA" = (/obj/item/weapon/shard,/obj/effect/decal/cleanable/blood/tracks/footprints,/obj/effect/decal/cleanable/vomit,/turf/simulated/floor/plating,/area/space)
"bB" = (/obj/machinery/door/airlock/external,/obj/effect/decal/cleanable/blood/tracks/footprints,/turf/simulated/floor/plating{icon_state = "warnplate"; dir = 4},/area/space)
"bC" = (/obj/item/weapon/shard,/obj/effect/decal/cleanable/blood/tracks/footprints,/turf/simulated/floor/plating/airless/asteroid,/area/space)
"bD" = (/obj/machinery/atmospherics/pipe/manifold/hidden/supply{dir = 8},/obj/structure/cable{d1 = 2; d2 = 4; icon_state = "2-4"},/obj/structure/cable{d1 = 1; d2 = 4; icon_state = "1-4"},/turf/simulated/floor/airless,/area/space)
"bE" = (/obj/machinery/atmospherics/pipe/simple/hidden/supply{dir = 4},/obj/structure/cable{d1 = 4; d2 = 8; icon_state = "4-8"},/turf/simulated/floor/airless,/area/space)
"bF" = (/obj/machinery/atmospherics/pipe/simple/hidden/supply{dir = 4},/obj/structure/extinguisher_cabinet{pixel_y = 30},/obj/structure/cable{d1 = 4; d2 = 8; icon_state = "4-8"},/turf/simulated/floor/airless,/area/space)
"bG" = (/obj/structure/cable{d1 = 2; d2 = 4; icon_state = "2-4"},/obj/structure/cable{d1 = 2; d2 = 8; icon_state = "2-8"},/obj/structure/cable{d1 = 4; d2 = 8; icon_state = "4-8"},/obj/structure/cable{d1 = 1; d2 = 2; icon_state = "1-2"},/obj/machinery/atmospherics/pipe/manifold4w/hidden/supply,/turf/simulated/floor/airless,/area/space)
"bH" = (/obj/machinery/atmospherics/pipe/simple/hidden/supply{dir = 4},/obj/structure/cable{d1 = 4; d2 = 8; icon_state = "4-8"},/obj/effect/decal/cleanable/blood,/turf/simulated/floor/airless,/area/space)
"bI" = (/obj/machinery/atmospherics/pipe/simple/hidden/supply{dir = 4},/obj/structure/cable{d1 = 4; d2 = 8; icon_state = "4-8"},/turf/simulated/floor/airless{icon_state = "floorscorched1"},/area/space)
"bJ" = (/obj/machinery/atmospherics/pipe/manifold/hidden/supply{dir = 4},/obj/structure/cable{d1 = 1; d2 = 8; icon_state = "1-8"},/obj/structure/cable{d1 = 2; d2 = 8; icon_state = "2-8"},/obj/effect/decal/cleanable/blood/tracks/footprints,/turf/simulated/floor/airless,/area/space)
"bK" = (/obj/machinery/optable,/obj/effect/decal/cleanable/blood/gibs/limb,/turf/simulated/floor{icon_state = "white"},/area/space)
"bL" = (/obj/machinery/computer/operating,/turf/simulated/floor{icon_state = "white"},/area/space)
"bM" = (/obj/machinery/atmospherics/pipe/simple/hidden/supply,/obj/structure/cable{d1 = 1; d2 = 2; icon_state = "1-2"},/obj/machinery/door/airlock/centcom,/turf/simulated/floor{icon_state = "white"},/area/space)
"bN" = (/obj/effect/decal/cleanable/blood/drip,/turf/simulated/floor/airless,/area/space)
"bO" = (/turf/simulated/floor/airless{icon_state = "damaged2"},/area/space)
"bP" = (/obj/machinery/atmospherics/unary/vent_pump{dir = 1; external_pressure_bound = 140; external_pressure_bound_default = 140; icon_state = "map_vent_out"; use_power = 1; pressure_checks = 0; pressure_checks_default = 0},/obj/structure/cable{d1 = 1; d2 = 2; icon_state = "1-2"},/turf/simulated/floor/airless,/area/space)
"bQ" = (/turf/simulated/floor/airless{icon_state = "floorscorched1"},/area/space)
"bR" = (/obj/effect/decal/cleanable/blood/gibs/robot,/turf/simulated/floor/airless,/area/space)
"bS" = (/obj/machinery/atmospherics/pipe/simple/hidden/supply,/obj/structure/cable{d1 = 1; d2 = 2; icon_state = "1-2"},/obj/machinery/door/airlock/centcom,/obj/effect/decal/cleanable/blood/tracks/footprints,/turf/simulated/floor/airless,/area/space)
"bT" = (/obj/structure/table,/obj/machinery/microwave,/obj/item/seeds/random,/obj/item/seeds/random,/turf/simulated/floor/airless,/area/space)
"bU" = (/obj/structure/closet/secure_closet/freezer/meat,/obj/effect/decal/cleanable/cobweb2,/turf/simulated/floor/airless,/area/space)
"bV" = (/obj/effect/decal/cleanable/blood/splatter,/turf/simulated/floor{icon_state = "white"},/area/space)
"bW" = (/obj/effect/decal/cleanable/blood/gibs/body,/turf/simulated/floor{icon_state = "white"},/area/space)
"bX" = (/obj/structure/table,/obj/machinery/light{tag = "icon-tube1 (NORTH)"; icon_state = "tube1"; dir = 1},/obj/item/weapon/storage/surgery_bag,/turf/simulated/floor{icon_state = "white"},/area/space)
"bY" = (/obj/machinery/atmospherics/pipe/simple/hidden/supply,/obj/structure/cable{d1 = 1; d2 = 2; icon_state = "1-2"},/obj/effect/decal/cleanable/blood/tracks/footprints,/turf/simulated/floor{icon_state = "white"},/area/space)
"bZ" = (/obj/machinery/power/smes,/obj/machinery/light,/obj/structure/cable,/turf/simulated/floor{icon_state = "dark"},/area/space)
"ca" = (/obj/machinery/atmospherics/pipe/simple/hidden/supply,/obj/structure/cable{d1 = 1; d2 = 2; icon_state = "1-2"},/obj/effect/decal/cleanable/blood/tracks/footprints,/turf/simulated/floor/airless,/area/space)
"cb" = (/obj/machinery/light{tag = "icon-tube1 (NORTH)"; icon_state = "tube1"; dir = 1},/turf/simulated/floor/airless,/area/space)
"cc" = (/obj/item/weapon/storage/firstaid,/obj/structure/table,/turf/simulated/floor{icon_state = "white"},/area/space)
"cd" = (/obj/machinery/atmospherics/unary/vent_pump{dir = 4; icon_state = "map_vent_out"; use_power = 1},/obj/effect/decal/cleanable/blood/gibs/limb,/turf/simulated/floor{icon_state = "white"},/area/space)
"ce" = (/obj/machinery/atmospherics/pipe/simple/hidden/supply{dir = 4; icon_state = "intact-supply"; tag = "icon-intact (EAST)"},/obj/effect/decal/cleanable/blood/gibs,/turf/simulated/floor{icon_state = "white"},/area/space)
"cf" = (/obj/machinery/atmospherics/pipe/simple/hidden/supply{dir = 9},/obj/structure/cable,/obj/effect/decal/cleanable/blood/splatter,/obj/effect/decal/cleanable/blood/tracks/footprints,/turf/simulated/floor{icon_state = "white"},/area/space)
"cg" = (/obj/structure/shuttle/engine/heater,/turf/simulated/shuttle/wall{icon_state = "wall3"},/area/space)
"ch" = (/obj/machinery/atmospherics/pipe/simple/hidden/supply{dir = 5},/obj/structure/cable,/obj/effect/decal/cleanable/blood/tracks/footprints,/obj/effect/decal/cleanable/blood/tracks/footprints,/turf/simulated/floor/airless,/area/space)
"ci" = (/obj/machinery/atmospherics/pipe/simple/hidden/supply{dir = 4; icon_state = "intact-supply"; tag = "icon-intact (EAST)"},/obj/effect/decal/cleanable/blood,/obj/effect/decal/cleanable/blood/tracks/footprints,/turf/simulated/floor/airless,/area/space)
"cj" = (/obj/machinery/atmospherics/unary/vent_pump{dir = 8; external_pressure_bound = 140; external_pressure_bound_default = 140; icon_state = "map_vent_out"; use_power = 1; pressure_checks = 0; pressure_checks_default = 0},/turf/simulated/floor/airless,/area/space)
"ck" = (/obj/structure/reagent_dispensers/watertank,/obj/item/weapon/reagent_containers/glass/bucket,/turf/simulated/floor/airless,/area/space)
"cl" = (/obj/machinery/sleeper{icon_state = "sleeper_0-r"; orient = "RIGHT"},/turf/simulated/floor{icon_state = "white"},/area/space)
"cm" = (/obj/machinery/sleep_console,/turf/simulated/floor{icon_state = "white"},/area/space)
"cn" = (/obj/effect/decal/cleanable/blood/gibs/limb,/obj/effect/decal/cleanable/blood/tracks/footprints,/turf/simulated/floor{icon_state = "white"},/area/space)
"co" = (/obj/structure/shuttle/engine/propulsion,/turf/space,/area/space)
"cp" = (/obj/machinery/seed_extractor,/turf/simulated/floor/airless,/area/space)
"cq" = (/obj/machinery/portable_atmospherics/hydroponics,/obj/machinery/light,/turf/simulated/floor/airless{icon_state = "damaged2"},/area/space)
"cr" = (/obj/machinery/portable_atmospherics/hydroponics,/obj/machinery/light,/turf/simulated/floor/airless,/area/space)
"cs" = (/turf/space,/turf/simulated/shuttle/wall{dir = 4; icon_state = "diagonalWall3"},/area/space)

(1,1,1) = {"
aaaaaaaaaaaaaaaaaaaaaaaaaaaaaaaaaaaaaaaaaaababababababaaaaaaaaaaaaaaaaaaaaaaaaaaaaaaaaaaaaaaaa
aaaaaaaaaaaaaaaaabacacacaaaaaaacacacacacababababababababaaaaaaaaaaaaaaaaaaaaaaaaaaaaaaaaaaaaaa
aaaaaaaaaaababababababacacacacacacacababababababababababaaaaaaaaaaaaaaaaaaaaaaaaaaaaaaaaaaaaaa
aaaaaaaaaaaaababababababababababababababababababababababababaaaaaaaaaaaaaaaaaaaaaaaaaaaaaaaaaa
aaaaaaaaaaaaababababababababababababababababababababababababababababababababababaaaaaaaaaaaaaa
aaaaaaaaaaaaababababababababacacacacacacacacababababababababababababababababababababaaaaaaaaaa
aaaaaaaaaaaaababababababacacacacacacacacacacacacacababababababababababababababababababaaaaaaaa
aaaaaaaaaaaaacabababacacacacabacacacacacadacacacacacabacacabababababababababababababababaaaaaa
aaaaaaaaaaacacacabacacacacacababacacacacacacacacacacacacacacabababababababababababababababaaaa
aaaaaaaaababacacacacacadacacacacacacabacacacacacacacacacacacacacacabababababababababababababaa
aaaaababababacacacacabacacacacacababababababacacacacacababacacacacacacacacacababababababababaa
aaababababacacacacacababacacacababababababababacacacacabababacacacacacacacacacabababababababab
aaababababacacacacacabababacacabababababababababacacacacacacacacacacacacacacacacababababababab
aaabababababacacacacacacabacababababababababababababacacacacacadacacababacacacacabacababababab
aaaaababababababababacacacacabababababababababababababacacacaeacacacababacacacacacacacabacabab
aaaaabababababababababadacacacabacacacacababababababababacacacacacacacabacacacacacacacacacacaa
aaacabababababababababacacacacacacacacacacacababababababacacacacacacacacacacacabacacacacacaaaa
aaacacabababababababacacacacacacacacafacagacacabababababacacacabacacacacacacacababacacacaaaaaa
aaacacacababababababacacacacadacacacacadacacacababababacacacabababacacacacacacababacacacaaaaaa
aaacacacabababababacacacafacaeacacacacacacacabababababacahacababababacacacacabababacacaaaaaaaa
aaacacacabababababababacacacacacacacacacabababababababacacacacabacacacacacacabababacaaaaaaaaaa
acacacababababababababababacacacacacacabababababababababacacacacacacacacabababababacaaaaaaaaaa
abacababababababababababababababababababababababababababacabacacacacabababababababaaaaaaaaaaaa
abababababababababababababababababababababababababababababababababababababababababaaaaaaaaaaaa
abababababababababababababababababababababababababababababababababababababababababaaaaaaaaaaaa
ababababababababababababababababababababababababababababababababababababababababababaaaaaaaaaa
aaababababababababababababababababababababababababacacacacacabababababababababababababaaaaaaaa
aaaaaaababababababababababababababababababababacacacacacacacacacacacacabacacababababababaaaaaa
aaaaaaaaababababacacacabababababababababababababacacacacacababacacacacacacacacacabababababaaaa
aaaaaaaiajajakacacalamacababababababababababacacacacacacabababababababacacacacacacabababababaa
aaaaaaajanaoajacacacalacacacacabababababababacacacacacabacacapapabababababacacacacacababababaa
aaaaaaajaqarajacacasacacalacacacababababababacacacacacacatacacapababababababacacacacababababaa
aaaaaiajauajajacasavacasacacajacabababababababacacacacacacawaxacapabababababacacacacababababaa
aaaaajayazaAajacacacalavasacajaBaCabababababababacacacawacacacacapababababacacacacacababababaa
aaaaajaDaEajajajakacacasaFajajajaGaHabababababababacacacacacacacababababacabacacacacababababaa
aaaaajaIaJaKaLaMajaNaOaPajaQaRaSaTaUacacacabababacawacabacacacababababacacacacacacacababababaa
aaaaaVajajajaWaXajaYaZbaajbbbcajajajacacacacabacacacabababacacababacacacacacacacacabababababaa
aaaaaabdbebfbgbhajbibjbkajblbmbnbobpacasacbqbqbqacabababababacacacacacacacacacababababababaaaa
aaaaaabrbsbtbubvajajbwajajbxbybzbAbBbCavbqbqacabababababababababacacacabacababababababababaaaa
aaaaaiajajajbDbEbEbFbGbHbEbIbJajajajakacacabababababababababababababababababababababababaaaaaa
aaaaajbKbLajbMajbNbObPbQbRajbSajbTbUajababababababababababababababababababababababababaaaaaaaa
aaaaajbVbWbXbYajajajbZajajajcacbbObQajababababababababababababacacacacabababababababaaaaaaaaaa
aaaaajcccdcecfajaacgcgcgaaajchcicjckajabababababababababababacacaaaaacacabababababaaaaaaaaaaaa
aaaaaVajclcmcnajaacococoaaajcpcqcrajcsaaabababababababababacacaaaaaaaaacacababaaaaaaaaaaaaaaaa
aaaaaaaVajajajcsaaaaaaaaaaaVajajajcsaaaaaaababababababababaaaaaaaaaaaaaaaaaaaaaaaaaaaaaaaaaaaa
aaaaaaaaaaaaaaaaaaaaaaaaaaaaaaaaaaaaaaaaaaaaaaaaababababaaaaaaaaaaaaaaaaaaaaaaaaaaaaaaaaaaaaaa
"}
