"aa" = (/turf/space,/area/space)
"ab" = (/obj/machinery/light/small/firelight,/turf/space,/area/space)
"ac" = (/turf/simulated/wall,/area/space)
"ad" = (/turf/simulated/floor/plating{icon_state = "warnplate"; dir = 9},/area/space)
"ae" = (/obj/machinery/light{tag = "icon-tube1 (NORTH)"; icon_state = "tube1"; dir = 1},/obj/structure/bed,/turf/simulated/floor/plating{dir = 1; icon_state = "warnplate"; nitrogen = 0.01; oxygen = 0.01},/area/space)
"af" = (/mob/living/simple_animal/cat,/turf/simulated/floor/plating{icon_state = "warnplate"; dir = 5},/area/space)
"ag" = (/turf/simulated/shuttle/wall{icon_state = "wall3"},/area/space)
"ah" = (/obj/structure/lattice,/turf/space,/area/space)
"ai" = (/obj/machinery/door/airlock/external,/turf/simulated/floor/plating,/area/space)
"aj" = (/mob/living/simple_animal/cat/kitten,/turf/simulated/floor/plating{icon_state = "warnplate"; dir = 8},/area/space)
"ak" = (/mob/living/simple_animal/cat/kitten,/turf/simulated/floor/plating,/area/space)
"al" = (/turf/simulated/floor/plating{icon_state = "warnplate"; dir = 4},/area/space)
"am" = (/turf/simulated/floor/plating{icon_state = "warnplate"; dir = 10},/area/space)
"an" = (/mob/living/simple_animal/cat/kitten,/turf/simulated/floor/plating{dir = 2; icon_state = "warnplate"},/area/space)
"ao" = (/turf/simulated/floor/plating{icon_state = "warnplate"; dir = 6},/area/space)
"ap" = (/obj/structure/grille,/obj/structure/window/reinforced{dir = 8},/obj/structure/window/reinforced{dir = 1},/obj/structure/window/reinforced,/turf/simulated/floor/plating,/area/space)
"aq" = (/obj/structure/window/reinforced{dir = 1},/obj/structure/grille{density = 0; icon_state = "brokengrille"},/turf/simulated/floor/plating,/area/space)
"ar" = (/obj/structure/window/reinforced{dir = 4},/obj/structure/window/reinforced{dir = 1},/obj/structure/grille{density = 0; icon_state = "brokengrille"},/turf/simulated/floor/plating,/area/space)
"as" = (/obj/structure/bed/chair/wood,/turf/space,/area/space)
"at" = (/turf/space,/turf/simulated/shuttle/wall{dir = 1; icon_state = "diagonalWall3"},/area/space)
"au" = (/obj/item/weapon/storage/box/donkpockets,/turf/space,/area/space)
"av" = (/obj/random/powercell,/turf/space,/area/space)
"aw" = (/obj/structure/table,/obj/random/powercell,/turf/simulated/floor/plating,/area/space)
"ax" = (/obj/structure/table,/obj/random/tool,/obj/random/tech_supply,/obj/item/stack/cable_coil,/turf/simulated/floor/plating,/area/space)
"ay" = (/obj/item/weapon/storage/firstaid/adv,/turf/space,/area/space)
"az" = (/obj/structure/grille,/obj/structure/window/reinforced{dir = 8},/obj/structure/window/reinforced{dir = 1},/obj/structure/window/reinforced,/obj/machinery/door/firedoor,/turf/simulated/floor/plating,/area/space)
"aA" = (/obj/structure/grille{density = 0; icon_state = "brokengrille"},/obj/structure/window/reinforced,/turf/simulated/floor/plating,/area/space)
"aB" = (/obj/structure/window/reinforced{dir = 1},/obj/structure/window/reinforced{dir = 4},/obj/structure/grille{density = 0; icon_state = "brokengrille"},/obj/structure/window/reinforced,/turf/simulated/floor/plating,/area/space)
"aC" = (/turf/simulated/floor/plating,/area/space)
"aD" = (/obj/random/toolbox,/turf/simulated/floor/plating,/area/space)
"aE" = (/turf/space,/turf/simulated/shuttle/wall{dir = 4; icon_state = "diagonalWall3"},/area/space)
"aF" = (/turf/simulated/floor/plating/airless,/area/space)
"aG" = (/turf/simulated/floor{dir = 8; icon_state = "barber"},/area/space)
"aH" = (/obj/item/weapon/storage/donut_box,/turf/simulated/floor{icon_state = "vault"; dir = 5},/area/space)
"aI" = (/obj/structure/bed/chair/wood,/turf/simulated/floor{icon_state = "vault"; dir = 5},/area/space)
"aJ" = (/obj/random/powercell,/turf/simulated/floor/plating,/area/space)
"aK" = (/obj/structure/table/rack,/turf/simulated/floor/plating,/area/space)
"aL" = (/obj/structure/closet/secure_closet/freezer/meat,/turf/simulated/floor{dir = 8; icon_state = "barber"},/area/space)
"aM" = (/obj/machinery/door/airlock/centcom{opacity = 1},/turf/simulated/floor{icon_state = "vault"; dir = 5},/area/space)
"aN" = (/turf/simulated/floor{icon_state = "vault"; dir = 5},/area/space)
"aO" = (/obj/structure/table/woodentable,/turf/simulated/floor{icon_state = "vault"; dir = 5},/area/space)
"aP" = (/obj/item/weapon/storage/firstaid/o2,/turf/space,/area/space)
"aQ" = (/obj/item/weapon/stool,/obj/structure/lattice,/turf/space,/area/space)
"aR" = (/obj/structure/cable/green{d1 = 4; d2 = 8; icon_state = "4-8"},/obj/structure/table/reinforced,/turf/simulated/floor/plating/airless,/area/space)
"aS" = (/obj/structure/table/woodentable,/obj/machinery/light{icon_state = "tube1"; dir = 4},/obj/item/weapon/newspaper,/turf/simulated/floor{icon_state = "vault"; dir = 5},/area/space)
"aT" = (/mob/living/simple_animal/hostile/carp,/turf/simulated/floor/plating/airless,/area/space)
"aU" = (/obj/machinery/sleeper{icon_state = "sleeper_0-r"; orient = "RIGHT"},/obj/structure/cable{d2 = 2; icon_state = "0-2"; pixel_y = 0},/turf/simulated/floor/plating/airless,/area/space)
"aV" = (/obj/machinery/sleep_console,/obj/machinery/alarm{frequency = 1441; pixel_y = 22},/turf/simulated/floor/plating/airless,/area/space)
"aW" = (/obj/item/weapon/stool,/turf/simulated/floor/plating/airless,/area/space)
"aX" = (/obj/structure/table/reinforced,/turf/simulated/floor/plating/airless,/area/space)
"aY" = (/obj/structure/table,/obj/machinery/microwave,/turf/simulated/floor{dir = 8; icon_state = "barber"},/area/space)
"aZ" = (/obj/machinery/vending/dinnerware,/turf/simulated/floor{dir = 8; icon_state = "barber"},/area/space)
"ba" = (/obj/structure/bed/chair/wood{dir = 1},/turf/simulated/floor{icon_state = "vault"; dir = 5},/area/space)
"bb" = (/obj/structure/closet/walllocker/emerglocker/west,/turf/simulated/floor/plating/airless,/area/space)
"bc" = (/obj/structure/grille,/obj/structure/window/reinforced{dir = 8},/obj/structure/window/reinforced{dir = 1},/obj/structure/window/reinforced,/obj/structure/window/reinforced{dir = 4},/turf/simulated/floor/plating,/area/space)
"bd" = (/obj/machinery/door/airlock/glass{req_access_txt = "101"},/turf/simulated/floor/plating,/area/space)
"be" = (/obj/structure/grille,/obj/structure/window/reinforced{dir = 1},/obj/structure/window/reinforced,/turf/simulated/floor/plating,/area/space)
"bf" = (/obj/structure/grille,/obj/structure/window/reinforced{dir = 1},/obj/structure/window/reinforced{dir = 4},/obj/structure/window/reinforced,/turf/simulated/floor/plating,/area/space)
"bg" = (/obj/structure/table,/turf/simulated/floor/plating/airless,/area/space)
"bh" = (/obj/item/weapon/storage/firstaid/toxin,/turf/space,/area/space)
"bi" = (/obj/structure/grille,/obj/structure/window/reinforced{dir = 4},/obj/structure/window/reinforced{dir = 1},/obj/structure/window/reinforced{dir = 8},/obj/machinery/door/firedoor,/turf/simulated/floor/plating/airless,/area/space)
"bj" = (/obj/structure/grille,/obj/structure/window/reinforced{dir = 8},/obj/structure/window/reinforced{dir = 1},/obj/structure/window/reinforced,/obj/structure/cable{d1 = 1; d2 = 2; icon_state = "1-2"; pixel_y = 0},/turf/simulated/floor/plating,/area/space)
"bk" = (/obj/structure/grille,/obj/structure/window/reinforced,/obj/structure/window/reinforced{dir = 4},/obj/structure/window/reinforced{dir = 8},/obj/machinery/door/firedoor,/turf/simulated/floor/plating/airless,/area/space)
"bl" = (/obj/machinery/media/jukebox,/turf/simulated/floor{icon_state = "bar"},/area/space)
"bm" = (/obj/structure/bed/chair/office/dark{dir = 1},/turf/simulated/floor/plating/airless,/area/space)
"bn" = (/obj/machinery/door/airlock/centcom{opacity = 1},/turf/simulated/floor/plating,/area/space)
"bo" = (/obj/structure/bed/chair/shuttle,/turf/simulated/floor/plating/airless,/area/space)
"bp" = (/obj/machinery/door/firedoor,/obj/machinery/door/airlock/centcom{req_access_txt = "101"},/turf/simulated/floor{icon_state = "vault"; dir = 5},/area/space)
"bq" = (/obj/structure/bed/chair/shuttle{tag = "icon-chair3 (EAST)"; icon_state = "chair3"; dir = 4},/turf/simulated/floor/plating/airless,/area/space)
"br" = (/obj/structure/grille,/obj/structure/window/reinforced{dir = 4},/obj/structure/window/reinforced{dir = 1},/turf/simulated/floor/plating,/area/space)
"bs" = (/mob/living/simple_animal/hostile/carp,/turf/simulated/floor/plating,/area/space)
"bt" = (/obj/structure/table/woodentable,/turf/space,/area/space)
"bu" = (/obj/structure/closet/emcloset,/turf/space,/area/space)
"bv" = (/obj/machinery/door/airlock/centcom,/turf/simulated/floor/plating/airless,/area/space)
"bw" = (/obj/structure/grille{density = 0; icon_state = "brokengrille"},/turf/simulated/floor/plating,/area/space)
"bx" = (/obj/structure/lattice/catwalk,/turf/space,/area/space)
"by" = (/obj/structure/cable{d1 = 1; d2 = 2; icon_state = "1-2"; pixel_y = 0},/obj/machinery/door/firedoor,/obj/machinery/atmospherics/pipe/simple/hidden/supply,/obj/machinery/door/airlock/centcom{opacity = 1},/turf/simulated/floor/plating,/area/space)
"bz" = (/obj/structure/closet/crate/solar,/turf/simulated/floor/plating{icon_state = "warnplate"; dir = 9},/area/space)
"bA" = (/turf/simulated/floor/plating{dir = 1; icon_state = "warnplate"; nitrogen = 0.01; oxygen = 0.01},/area/space)
"bB" = (/obj/structure/shuttle/engine/propulsion/burst{dir = 4},/turf/space,/area/space)
"bC" = (/obj/structure/shuttle/engine/router,/turf/simulated/shuttle/wall{icon_state = "wall3"},/area/space)
"bD" = (/obj/structure/table/rack,/turf/simulated/floor/plating/airless,/area/space)
"bE" = (/obj/item/clothing/head/helmet/space,/turf/simulated/floor/plating/airless,/area/space)
"bF" = (/turf/simulated/floor/plating{icon_state = "warnplate"; dir = 8},/area/space)
"bG" = (/obj/machinery/power/rad_collector,/turf/simulated/floor/plating{icon_state = "warnplate"; dir = 4},/area/space)
"bH" = (/obj/machinery/power/emitter{dir = 8; icon_state = "emitter"; state = 2; tag = "icon-emitter (WEST)"},/turf/simulated/floor/plating{icon_state = "warnplate"; dir = 10},/area/space)
"bI" = (/obj/machinery/power/rad_collector,/obj/machinery/light,/turf/simulated/floor/plating{dir = 2; icon_state = "warnplate"},/area/space)
"bJ" = (/obj/item/clothing/suit/space,/turf/simulated/floor/plating/airless,/area/space)
"bK" = (/obj/item/device/camera,/turf/space,/area/space)
"bL" = (/obj/machinery/light/small/firelight{tag = "icon-firelight1 (NORTH)"; icon_state = "firelight1"; dir = 1},/turf/space,/area/space)

(1,1,1) = {"
aaaaaaaaaaaaaaaaaaaaaaaaaaaaaaaaaaabaaaaaaabaaaaaaaaaaaaaaaaaaaaaaaaaaaaaaaaaaaa
aaaaaaaaaaaaaaaaaaaaaaaaaaaaaaaaaaacacacacacaaaaaaaaaaaaaaaaaaaaaaaaaaaaaaaaaaaa
aaaaaaaaaaaaaaaaaaaaaaaaaaaaaaaaaaacadaeafacaaaaaaaaaaaaagaaaaaaaaaaaaaaaaaaaaaa
aaaaaaaaaaaaaaahaaagagagaaaaaaaaaaaiajakalacaaaaaaaaaaahagagaaaaaaaaaaaaaaaaaaaa
aaaaaaaaaaaaaaaaahahahahahaaaaaaaaacamanaoacaaaaaaaaahaaaaaaaaaaaaaaaaaaaaaaaaaa
aaaaaaaaaaaaaaahahaaahaaaaaaaaaaaaacapaqaracaaaaaaaaaaaaaaaaaaaaaaaaaaaaaaaaaaaa
aaaaaaaaaaaaaaaaahaaaaaaaaaaaaaaaaaaaaaaaaaaaaaaaaaaaaaaaaaaaaaaaaaaaaasaaaaaaaa
aaaaaaaaaaaaaaaaaaaaaaaaaaaaaaaaaaaaaaaaaaaaaaaaaaaaaaaaaaaaaaaaaaaaaaaaaaaaaaaa
aaaaahahaaahagagataaaaaaaaaaaaaaaaahahahahaaaaaaaaauaaaaaaaaaaaaaaaaaaaaaaaaaaaa
ahahavahaaawaxagagaaaaaaayaaaaaaahaaaaaaaaahahaaaaaaahaaaaagagagazaAaBataaaaaaaa
ahaaaaahaCaDaCagaEaaaaaaaaaaaaaaahaaaaahahaaahaaaaaaaaahahaFaGagaHaIaIagaaahaaaa
ahahahaCaJaCaKagaaaaaaaaaaaaaaaaahaaahahaaaaahahaaahahahaFaLaGaMaNaOaOagaaaaaaaa
aaahahagaCagagagaaaPahahaaaaaaaaahahaaahahaaaaahahaQaRaFaGaGaGagaNaOaSagaaaaaaaa
aaahaFaFaTagaUaVahahahaaaaaaaaahahaaahaaahaaaaaFaFaWaXaGaYaGaZagaNbabaagaaaaahaa
ahaaaFaFaFagbbaFaFaaahaaahahahagbcbdapbebfagagaFaFaFagagagaNagagaMagagagaaahaaaa
aaagaTaFaFagaFbgbgagaabhaaaaahaFaFaFaFaFaFaFaFaFaFaFaFaFaFaFaFaFaFaFbiaaaaahahaa
aaagagagaMagaFagagagaaaaaaaaaaagbcbdbjbebfagagaFaFaFaFaFaFaFaFaFaFaFbkaaaaaaaaaa
aaaFaFagaFaFaFaFaFaFaaahahahaaagaFaFaFaFaFaFagblbmaFagaFaFagaMagaMagagagagaaaaaa
aaagagagbnagaFagagagaaaaaaaaahaaaaaaaFaFaFaFagaFaFaaahaaaFaFaFagaFboboagagagagat
ahagaCaCaCagaFaFaFagaaaaaaaaaaaaaaaaaFaFaFaFbpahahahahaaaaaFaFagaFaFaFagaTbqaFbr
aaagaCbsaCagbbaFaFahahaaaaaaavaaaaaaaaaFaFagagaaaaahaaahahaFbtahbuaFaFbvaFaFbqbw
aaagaCaCaCagaFaFaFahaaaaaaacacaiahaaaabxbxagaaaaaaaaaaahaaahahaaahaaagagagagagaE
agagagagbyagagahaaaaaaaaahacbzbAahahaaaaaaaaaaaaaaaaaaaaaaaaaabuaaahaaaaaaaaaaaa
bBbCagbDbEbgahahaaaaaaahahacbFaCbGacaaahaaaaahahahaaaaaaaaavaaaaahaaaaaaaaaaaaaa
bBbCagaFaFaFahaaaaaaahahaaacbHbIaoacaaaaahahahaFagaaaaaaaaaaaaaaaaaaaaaaaaaaaaaa
bBbCagaFbJaaaabKaaaaahaaaaacacacacacaaaaaaahaFahaaaaaaaaaaaaaaaaaaaaaaaaaaaaaaaa
bBbCahahahaaaaaaaaaaaaaaaabLaaaaaabLaaaaaaaaaaaaaaaaaaaaaaaaaaaaaaaaaaaaaaaaaaaa
"}
