"aa" = (/turf/space,/area/space)
"ab" = (/turf/space,/turf/simulated/shuttle/wall{dir = 8; icon_state = "diagonalWall3"},/area/space)
"ac" = (/obj/structure/grille,/obj/structure/window/reinforced,/obj/structure/window/reinforced{dir = 1},/obj/structure/window/reinforced{dir = 8},/obj/machinery/door/blast/shutters{density = 0; icon_state = "shutter0"; id = "syndieshutters"; name = "Blast Shutters"; opacity = 0},/turf/simulated/shuttle/plating,/area/space)
"ad" = (/obj/structure/grille,/obj/structure/window/reinforced,/obj/structure/window/reinforced{dir = 1},/obj/machinery/door/blast/shutters{density = 0; icon_state = "shutter0"; id = "syndieshutters"; name = "Blast Shutters"; opacity = 0},/turf/simulated/shuttle/plating,/area/space)
"ae" = (/obj/structure/grille,/obj/structure/window/reinforced,/obj/structure/window/reinforced{dir = 1},/obj/structure/window/reinforced{dir = 4},/obj/machinery/door/blast/shutters{density = 0; icon_state = "shutter0"; id = "syndieshutters"; name = "Blast Shutters"; opacity = 0},/turf/simulated/shuttle/plating,/area/space)
"af" = (/turf/space,/turf/simulated/shuttle/wall{dir = 1; icon_state = "diagonalWall3"},/area/space)
"ag" = (/turf/simulated/shuttle/wall{icon_state = "wall3"},/area/space)
"ah" = (/obj/structure/table,/obj/machinery/recharger,/turf/simulated/shuttle/floor{icon_state = "floor6"},/area/space)
"ai" = (/obj/machinery/computer/security/nuclear,/turf/simulated/shuttle/floor{icon_state = "floor6"},/area/space)
"aj" = (/obj/machinery/computer/shuttle_control/multi/syndicate{req_access_txt = "0"},/turf/simulated/shuttle/floor{icon_state = "floor6"},/area/space)
"ak" = (/obj/structure/computerframe,/turf/simulated/shuttle/floor{icon_state = "floor6"},/area/space)
"al" = (/obj/structure/table,/obj/machinery/door_control{id = "syndieshutters"; name = "remote shutter control"; req_access_txt = "150"},/turf/simulated/shuttle/floor{icon_state = "floor6"},/area/space)
"am" = (/obj/structure/table,/obj/machinery/microwave{pixel_x = -1; pixel_y = 2},/turf/simulated/shuttle/floor{icon_state = "floor6"},/area/space)
"an" = (/turf/simulated/shuttle/floor{icon_state = "floor6"},/area/space)
"ao" = (/obj/structure/bed/chair{dir = 1},/turf/simulated/shuttle/floor{icon_state = "floor6"},/area/space)
"ap" = (/obj/structure/table,/obj/item/weapon/storage/box/donkpockets{pixel_x = 2; pixel_y = 3},/turf/simulated/shuttle/floor{icon_state = "floor6"},/area/space)
"aq" = (/obj/structure/bed/chair{dir = 4},/turf/simulated/shuttle/floor{icon_state = "floor6"},/area/space)
"ar" = (/obj/structure/table,/obj/item/stack/sheet/glass{amount = 15},/obj/item/weapon/cell{charge = 100; maxcharge = 15000},/turf/simulated/shuttle/floor{icon_state = "floor6"},/area/space)
"as" = (/obj/item/device/radio/intercom{desc = "Talk through this. Evilly"; freerange = 1; frequency = 1213; name = "Syndicate Intercom"; pixel_y = -32; subspace_transmission = 1; syndie = 1},/turf/simulated/shuttle/floor{icon_state = "floor6"},/area/space)
"at" = (/obj/structure/table,/obj/item/weapon/paper_bin{pixel_x = -3; pixel_y = 8},/obj/item/weapon/pen{pixel_y = 4},/turf/simulated/shuttle/floor{icon_state = "floor6"},/area/space)
"au" = (/turf/space,/turf/simulated/shuttle/wall{icon_state = "diagonalWall3"},/area/space)
"av" = (/obj/machinery/door/window/northright{name = "Flight Deck"; req_access_txt = "150"},/turf/simulated/shuttle/floor{icon_state = "floor6"},/area/space)
"aw" = (/turf/space,/turf/simulated/shuttle/wall{dir = 4; icon_state = "diagonalWall3"},/area/space)
"ax" = (/obj/structure/closet/secure_closet/medical_wall{pixel_x = -32; pixel_y = 0; req_access = null; req_access_txt = "150"},/obj/item/stack/medical/splint,/obj/item/stack/medical/ointment,/obj/item/stack/medical/ointment,/obj/item/stack/medical/bruise_pack,/obj/item/stack/medical/bruise_pack,/obj/item/stack/medical/bruise_pack,/obj/item/weapon/storage/belt/medical,/obj/item/weapon/storage/belt/medical,/turf/simulated/shuttle/floor{icon_state = "floor6"},/area/space)
"ay" = (/obj/structure/bed/chair{dir = 8},/turf/simulated/shuttle/floor{icon_state = "floor6"},/area/space)
"az" = (/obj/structure/closet/hydrant{pixel_y = 32},/turf/simulated/shuttle/floor{icon_state = "floor6"},/area/space)
"aA" = (/obj/structure/table/rack,/obj/item/weapon/storage/belt/security,/obj/item/weapon/storage/belt/security,/turf/simulated/shuttle/floor{icon_state = "floor6"},/area/space)
"aB" = (/obj/machinery/recharger/wallcharger{pixel_x = -25},/turf/simulated/shuttle/floor{icon_state = "floor6"},/area/space)
"aC" = (/obj/structure/bed/chair{dir = 8},/obj/structure/bed/chair{dir = 8},/turf/simulated/shuttle/floor{icon_state = "floor6"},/area/space)
"aD" = (/obj/structure/closet,/turf/simulated/shuttle/floor{icon_state = "floor6"},/area/space)
"aE" = (/obj/structure/sign/poster{poster_type = "/datum/poster/bay_50"; pixel_x = -32},/turf/simulated/shuttle/floor{icon_state = "floor6"},/area/space)
"aF" = (/obj/structure/toilet{dir = 4},/turf/simulated/shuttle/floor{icon_state = "floor7"},/area/space)
"aG" = (/obj/machinery/flasher{id = "syndieflash"; pixel_x = 0; pixel_y = 28},/turf/simulated/shuttle/floor{icon_state = "floor7"},/area/space)
"aH" = (/obj/item/device/radio/electropack,/turf/simulated/shuttle/floor{icon_state = "floor7"},/area/space)
"aI" = (/obj/item/device/radio/intercom{desc = "Talk through this. Evilly"; freerange = 1; frequency = 1213; name = "Syndicate Intercom"; pixel_x = 0; pixel_y = -32; subspace_transmission = 1; syndie = 1},/turf/simulated/shuttle/floor{icon_state = "floor6"},/area/space)
"aJ" = (/obj/structure/closet/walllocker/emerglocker{pixel_x = 28},/turf/simulated/shuttle/floor{icon_state = "floor6"},/area/space)
"aK" = (/obj/machinery/atmospherics/unary/vent_pump/high_volume{dir = 4; frequency = 1331; id_tag = "synd_pump"},/turf/simulated/shuttle/floor{icon_state = "floor6"},/area/space)
"aL" = (/obj/machinery/atmospherics/pipe/manifold/visible{dir = 1},/obj/machinery/airlock_sensor{frequency = 1331; id_tag = "synd_sensor"; pixel_x = 8; pixel_y = 25},/turf/simulated/shuttle/floor{icon_state = "floor6"},/area/space)
"aM" = (/obj/machinery/atmospherics/unary/vent_pump/high_volume{dir = 8; frequency = 1331; id_tag = "synd_pump"},/obj/machinery/embedded_controller/radio/airlock/airlock_controller{frequency = 1331; id_tag = "synd_airlock"; pixel_x = -8; pixel_y = 25; req_access_txt = "0"; tag_airpump = "synd_pump"; tag_chamber_sensor = "synd_sensor"; tag_exterior_door = "synd_outer"; tag_interior_door = "synd_inner"},/turf/simulated/shuttle/floor{icon_state = "floor6"},/area/space)
"aN" = (/obj/machinery/door/airlock/external{frequency = 1331; icon_state = "door_closed"; id_tag = "synd_outer"; locked = 0; name = "Ship External Access"; req_access = null; req_access_txt = "150"},/obj/machinery/door/blast/regular{density = 0; icon_state = "pdoor0"; id = "smindicate"; name = "Outer Airlock"; opacity = 0},/turf/simulated/shuttle/plating,/area/space)
"aO" = (/obj/structure/window/reinforced{dir = 4},/obj/structure/window/reinforced{dir = 8},/obj/structure/grille,/obj/structure/window/reinforced{dir = 1},/obj/structure/window/reinforced,/turf/unsimulated/floor{icon_state = "floor5"},/area/space)
"aP" = (/turf/simulated/shuttle/floor{icon_state = "floor7"},/area/space)
"aQ" = (/obj/item/weapon/cigbutt,/turf/simulated/shuttle/floor{icon_state = "floor7"},/area/space)
"aR" = (/obj/machinery/door/window{dir = 2; name = "Seating"; req_access_txt = "150"},/turf/simulated/shuttle/floor{icon_state = "floor6"},/area/space)
"aS" = (/obj/structure/table,/obj/machinery/computer/pod/old/syndicate{id = "smindicate"},/obj/machinery/door/window{dir = 4; name = "Blast Door Control"; req_access_txt = "150"},/turf/simulated/shuttle/floor{icon_state = "floor6"},/area/space)
"aT" = (/obj/machinery/atmospherics/pipe/manifold4w/visible,/turf/simulated/shuttle/floor{icon_state = "floor6"},/area/space)
"aU" = (/obj/machinery/atmospherics/unary/vent_pump/high_volume{dir = 8; frequency = 1331; id_tag = "synd_pump"},/turf/simulated/shuttle/floor{icon_state = "floor6"},/area/space)
"aV" = (/obj/machinery/door/window{dir = 1; name = "Cell"; req_access_txt = "150"},/obj/item/device/radio/intercom{desc = "Talk through this. Evilly"; freerange = 1; frequency = 1213; name = "Syndicate Intercom"; pixel_x = -32; subspace_transmission = 1; syndie = 1},/turf/simulated/shuttle/floor{icon_state = "floor6"},/area/space)
"aW" = (/obj/machinery/vending/assist{contraband = null; name = "AntagCorpVent"; products = list(/obj/item/device/assembly/prox_sensor = 5, /obj/item/device/assembly/signaler = 4, /obj/item/device/assembly/infra = 4, /obj/item/device/assembly/prox_sensor = 4, /obj/item/weapon/handcuffs = 8, /obj/item/device/flash = 4, /obj/item/weapon/cartridge/signal = 4)},/turf/simulated/shuttle/floor{icon_state = "floor6"},/area/space)
"aX" = (/obj/structure/grille,/obj/structure/window/reinforced,/obj/structure/window/reinforced{dir = 4},/obj/structure/window/reinforced{dir = 1},/obj/structure/window/reinforced{dir = 8},/turf/simulated/shuttle/plating,/area/space)
"aY" = (/obj/machinery/door/airlock/external{frequency = 1331; icon_state = "door_closed"; id_tag = "synd_inner"; locked = 0; name = "Ship External Access"; req_access = null; req_access_txt = "0"},/obj/machinery/atmospherics/pipe/simple/visible,/turf/simulated/shuttle/floor{icon_state = "floor6"},/area/space)
"aZ" = (/obj/structure/bed/chair{dir = 8},/obj/machinery/flasher_button{id = "syndieflash"; name = "Flasher"; pixel_x = 27; pixel_y = 0; tag = "permflash"},/turf/simulated/shuttle/floor{icon_state = "floor6"},/area/space)
"ba" = (/obj/machinery/atmospherics/pipe/tank/air{dir = 4; start_pressure = 740.5},/turf/simulated/shuttle/floor{icon_state = "floor6"},/area/space)
"bb" = (/obj/machinery/atmospherics/pipe/simple/visible{dir = 4},/turf/simulated/shuttle/floor{icon_state = "floor6"},/area/space)
"bc" = (/obj/machinery/access_button{command = "cycle_interior"; frequency = 1331; master_tag = "synd_airlock"; name = "interior access button"; pixel_x = 25; pixel_y = 25; req_access_txt = "0"},/obj/machinery/atmospherics/pipe/simple/visible{tag = "icon-intact (NORTHWEST)"; icon_state = "intact"; dir = 9},/turf/simulated/shuttle/floor{icon_state = "floor6"},/area/space)
"bd" = (/obj/machinery/suit_cycler/syndicate{locked = 0},/turf/simulated/shuttle/floor{icon_state = "floor6"},/area/space)
"be" = (/obj/structure/table,/obj/item/weapon/kitchen/utensil/knife{pixel_x = -6},/obj/item/weapon/reagent_containers/syringe/drugs{pixel_x = 3; pixel_y = -1},/obj/item/weapon/reagent_containers/syringe/drugs{pixel_x = 3; pixel_y = 4},/obj/item/weapon/reagent_containers/syringe/drugs{pixel_x = 3; pixel_y = 9},/turf/simulated/shuttle/floor{icon_state = "floor6"},/area/space)
"bf" = (/obj/machinery/door/window{dir = 4; name = "Brig"; req_access_txt = "150"},/turf/simulated/shuttle/floor{icon_state = "floor6"},/area/space)
"bg" = (/obj/machinery/door/window{base_state = "right"; dir = 8; icon_state = "right"; name = "Preparation"; req_access_txt = "150"},/turf/simulated/shuttle/floor{icon_state = "floor6"},/area/space)
"bh" = (/obj/structure/closet/syndicate/suit{name = "suit closet"},/turf/simulated/shuttle/floor{icon_state = "floor6"},/area/space)
"bi" = (/obj/structure/closet{name = "custodial"},/obj/item/weapon/reagent_containers/glass/bucket,/obj/item/weapon/mop,/obj/item/weapon/reagent_containers/spray/cleaner,/turf/simulated/shuttle/floor{icon_state = "floor6"},/area/space)
"bj" = (/obj/machinery/door/window{base_state = "right"; dir = 4; icon_state = "right"; name = "Brig"; req_access_txt = "150"},/turf/simulated/shuttle/floor{icon_state = "floor6"},/area/space)
"bk" = (/obj/machinery/door/window{base_state = "left"; dir = 8; icon_state = "left"; name = "Preparation"; req_access_txt = "150"},/turf/simulated/shuttle/floor{icon_state = "floor6"},/area/space)
"bl" = (/obj/structure/table,/obj/item/weapon/storage/toolbox/syndicate{pixel_x = -1; pixel_y = 3},/turf/simulated/shuttle/floor{icon_state = "floor6"},/area/space)
"bm" = (/obj/machinery/sleeper,/turf/simulated/shuttle/floor{icon_state = "floor3"},/area/space)
"bn" = (/obj/machinery/sleep_console,/turf/simulated/shuttle/floor{icon_state = "floor3"},/area/space)
"bo" = (/obj/machinery/portable_atmospherics/canister/oxygen,/obj/structure/sign/nosmoking_1{pixel_y = 32},/turf/simulated/shuttle/floor{icon_state = "floor3"},/area/space)
"bp" = (/obj/structure/table,/obj/item/roller{pixel_y = 8},/turf/simulated/shuttle/floor{icon_state = "floor3"},/area/space)
"bq" = (/obj/structure/table,/obj/structure/closet/secure_closet/medical_wall{pixel_y = 32; req_access = null; req_access_txt = "150"},/obj/item/bodybag,/obj/item/weapon/reagent_containers/syringe/antiviral,/obj/item/weapon/reagent_containers/syringe/antiviral,/obj/item/weapon/reagent_containers/syringe/antiviral,/obj/item/weapon/reagent_containers/glass/bottle/antitoxin{pixel_x = -4; pixel_y = 8},/obj/item/weapon/reagent_containers/glass/bottle/inaprovaline{pixel_x = 4; pixel_y = 7},/obj/item/weapon/reagent_containers/syringe,/turf/simulated/shuttle/floor{icon_state = "floor3"},/area/space)
"br" = (/obj/item/device/radio/intercom{desc = "Talk through this. Evilly"; freerange = 1; frequency = 1213; name = "Syndicate Intercom"; pixel_x = -32; subspace_transmission = 1; syndie = 1},/turf/simulated/shuttle/floor{icon_state = "floor6"},/area/space)
"bs" = (/obj/structure/table,/obj/item/clothing/gloves/yellow,/obj/item/device/assembly/signaler{pixel_y = 2},/obj/item/clothing/glasses/night,/turf/simulated/shuttle/floor{icon_state = "floor6"},/area/space)
"bt" = (/obj/structure/table,/obj/item/clothing/gloves/yellow,/obj/item/device/assembly/prox_sensor{pixel_x = -8; pixel_y = 4},/obj/item/clothing/glasses/night,/turf/simulated/shuttle/floor{icon_state = "floor6"},/area/space)
"bu" = (/obj/structure/window/reinforced{dir = 1},/obj/structure/window/reinforced{dir = 8},/obj/structure/window/reinforced{dir = 4},/obj/structure/grille,/obj/machinery/door/blast/shutters{density = 0; dir = 8; icon_state = "shutter0"; id = "syndieshutters_infirmary"; name = "Blast Shutters"; opacity = 0},/turf/simulated/shuttle/plating,/area/space)
"bv" = (/turf/simulated/shuttle/floor{icon_state = "floor3"},/area/space)
"bw" = (/obj/structure/table,/obj/item/weapon/screwdriver,/obj/effect/spawner/newbomb/timer/syndicate,/turf/simulated/shuttle/floor{icon_state = "floor6"},/area/space)
"bx" = (/obj/structure/window/reinforced{dir = 1},/obj/structure/window/reinforced{dir = 8},/obj/structure/window/reinforced{dir = 4},/obj/structure/grille,/obj/machinery/door/blast/shutters{density = 0; dir = 4; icon_state = "shutter0"; id = "syndieshutters_workshop"; name = "Blast Shutters"; opacity = 0},/turf/simulated/shuttle/plating,/area/space)
"by" = (/obj/structure/window/reinforced{dir = 8},/obj/structure/window/reinforced{dir = 4},/obj/structure/grille,/obj/machinery/door/blast/shutters{density = 0; dir = 8; icon_state = "shutter0"; id = "syndieshutters_infirmary"; name = "Blast Shutters"; opacity = 0},/turf/simulated/shuttle/plating,/area/space)
"bz" = (/obj/machinery/bodyscanner,/turf/simulated/shuttle/floor{icon_state = "floor3"},/area/space)
"bA" = (/obj/machinery/body_scanconsole,/turf/simulated/shuttle/floor{icon_state = "floor3"},/area/space)
"bB" = (/obj/machinery/door/window{dir = 4; name = "Infirmary"; req_access_txt = "150"},/turf/simulated/shuttle/floor{icon_state = "floor3"},/area/space)
"bC" = (/obj/machinery/door/window/westright{name = "Tool Storage"; req_access_txt = "150"},/turf/simulated/shuttle/floor{icon_state = "floor6"},/area/space)
"bD" = (/obj/item/weapon/stool{pixel_y = 8},/turf/simulated/shuttle/floor{icon_state = "floor6"},/area/space)
"bE" = (/obj/structure/table,/obj/effect/spawner/newbomb/timer/syndicate,/turf/simulated/shuttle/floor{icon_state = "floor6"},/area/space)
"bF" = (/obj/structure/window/reinforced{dir = 8},/obj/structure/window/reinforced{dir = 4},/obj/structure/grille,/obj/machinery/door/blast/shutters{density = 0; dir = 4; icon_state = "shutter0"; id = "syndieshutters_workshop"; name = "Blast Shutters"; opacity = 0},/turf/simulated/shuttle/plating,/area/space)
"bG" = (/obj/structure/window/reinforced,/obj/structure/window/reinforced{dir = 8},/obj/structure/window/reinforced{dir = 4},/obj/structure/grille,/obj/machinery/door/blast/shutters{density = 0; dir = 8; icon_state = "shutter0"; id = "syndieshutters_infirmary"; name = "Blast Shutters"; opacity = 0},/turf/simulated/shuttle/plating,/area/space)
"bH" = (/obj/machinery/door/window{base_state = "right"; dir = 4; icon_state = "right"; name = "Infirmary"; req_access_txt = "150"},/turf/simulated/shuttle/floor{icon_state = "floor3"},/area/space)
"bI" = (/obj/machinery/door/window{dir = 8; name = "Tool Storage"; req_access_txt = "150"},/turf/simulated/shuttle/floor{icon_state = "floor6"},/area/space)
"bJ" = (/obj/structure/table,/obj/item/device/aicard,/obj/effect/spawner/newbomb/timer/syndicate,/turf/simulated/shuttle/floor{icon_state = "floor6"},/area/space)
"bK" = (/obj/structure/window/reinforced,/obj/structure/window/reinforced{dir = 8},/obj/structure/window/reinforced{dir = 4},/obj/structure/grille,/obj/machinery/door/blast/shutters{density = 0; dir = 4; icon_state = "shutter0"; id = "syndieshutters_workshop"; name = "Blast Shutters"; opacity = 0},/turf/simulated/shuttle/plating,/area/space)
"bL" = (/obj/machinery/door_control{id = "syndieshutters_infirmary"; name = "remote shutter control"; pixel_x = -25; req_access_txt = "0"},/obj/structure/mopbucket,/turf/simulated/shuttle/floor{icon_state = "floor3"},/area/space)
"bM" = (/obj/item/device/radio/intercom{desc = "Talk through this. Evilly"; freerange = 1; frequency = 1213; name = "Syndicate Intercom"; pixel_x = 32; subspace_transmission = 1; syndie = 1},/turf/simulated/shuttle/floor{icon_state = "floor3"},/area/space)
"bN" = (/obj/machinery/door/window{dir = 1; name = "Secure Storage"; req_access_txt = "150"},/turf/simulated/shuttle/floor{icon_state = "floor6"},/area/space)
"bO" = (/obj/structure/table/rack,/obj/item/weapon/storage/belt/utility/full,/obj/item/device/multitool,/turf/simulated/shuttle/floor{icon_state = "floor6"},/area/space)
"bP" = (/obj/machinery/door_control{id = "syndieshutters_telebay"; name = "remote shutter control"; pixel_x = 0; pixel_y = -25; req_access_txt = "150"},/turf/simulated/shuttle/floor{icon_state = "floor6"},/area/space)
"bQ" = (/obj/machinery/door_control{id = "syndieshutters_workshop"; name = "remote shutter control"; pixel_x = 25; req_access_txt = "0"},/turf/simulated/shuttle/floor{icon_state = "floor6"},/area/space)
"bR" = (/obj/structure/window/reinforced{dir = 1},/obj/structure/table,/obj/item/weapon/bonesetter,/obj/item/weapon/bonegel,/turf/simulated/shuttle/floor{icon_state = "floor3"},/area/space)
"bS" = (/obj/machinery/door/window{dir = 1; name = "Surgery"; req_access_txt = "150"},/turf/simulated/shuttle/floor{icon_state = "floor3"},/area/space)
"bT" = (/obj/structure/window/reinforced{dir = 1},/turf/simulated/shuttle/floor{icon_state = "floor3"},/area/space)
"bU" = (/obj/structure/table,/obj/structure/window/reinforced{dir = 8},/obj/item/weapon/storage/firstaid/toxin{pixel_x = 3; pixel_y = 3},/obj/item/weapon/storage/firstaid/adv{pixel_x = 1},/turf/simulated/shuttle/floor{icon_state = "floor3"},/area/space)
"bV" = (/obj/structure/table,/obj/item/weapon/storage/firstaid/o2{pixel_x = 3; pixel_y = 3},/obj/item/weapon/storage/firstaid/fire{pixel_x = 1},/turf/simulated/shuttle/floor{icon_state = "floor3"},/area/space)
"bW" = (/obj/item/weapon/weldingtool,/turf/simulated/shuttle/floor{icon_state = "floor6"},/area/space)
"bX" = (/obj/structure/sign/securearea{name = "\improper CAUTION"; pixel_x = 32},/turf/simulated/shuttle/floor{icon_state = "floor6"},/area/space)
"bY" = (/obj/machinery/telecomms/allinone{intercept = 1},/obj/machinery/door/window/northright{name = "Telecoms Mainframe"; req_access_txt = "150"},/turf/simulated/shuttle/floor{icon_state = "floor6"},/area/space)
"bZ" = (/obj/machinery/door/blast/regular{id = "syndieshutters_telebay"; name = "Outer Airlock"},/turf/simulated/shuttle/plating,/area/space)
"ca" = (/obj/structure/table,/obj/item/weapon/scalpel,/obj/item/weapon/circular_saw{pixel_y = 8},/turf/simulated/shuttle/floor{icon_state = "floor3"},/area/space)
"cb" = (/obj/structure/sink{dir = 4; icon_state = "sink"; pixel_x = 11; pixel_y = 0},/turf/simulated/shuttle/floor{icon_state = "floor3"},/area/space)
"cc" = (/obj/structure/closet/secure_closet/medical_wall{pixel_y = 0; req_access = null; req_access_txt = "150"},/obj/item/weapon/surgicaldrill,/obj/item/clothing/gloves/latex,/obj/item/clothing/mask/surgical,/obj/item/weapon/reagent_containers/glass/bottle/stoxin,/obj/item/weapon/reagent_containers/glass/bottle/stoxin,/obj/item/weapon/reagent_containers/syringe,/turf/simulated/shuttle/wall{icon_state = "wall3"},/area/space)
"cd" = (/obj/item/weapon/crowbar,/turf/simulated/shuttle/floor{icon_state = "floor6"},/area/space)
"ce" = (/obj/structure/sign/nosmoking_2{pixel_x = 32},/turf/simulated/shuttle/floor{icon_state = "floor6"},/area/space)
"cf" = (/obj/structure/table,/obj/item/weapon/cautery,/obj/item/weapon/hemostat,/turf/simulated/shuttle/floor{icon_state = "floor3"},/area/space)
"cg" = (/obj/machinery/optable,/turf/simulated/shuttle/floor{icon_state = "floor3"},/area/space)
"ch" = (/obj/structure/table,/obj/item/stack/medical/advanced/bruise_pack,/obj/item/weapon/retractor,/obj/item/device/radio/intercom{desc = "Talk through this. Evilly"; freerange = 1; frequency = 1213; name = "Syndicate Intercom"; pixel_x = 32; subspace_transmission = 1; syndie = 1},/turf/simulated/shuttle/floor{icon_state = "floor3"},/area/space)
"ci" = (/obj/structure/shuttle/engine/heater,/obj/structure/window/reinforced{dir = 1},/turf/simulated/floor/plating/airless,/area/space)
"cj" = (/obj/structure/shuttle/engine/propulsion{icon_state = "propulsion_l"},/turf/space,/area/space)
"ck" = (/obj/structure/shuttle/engine/propulsion,/turf/space,/area/space)
"cl" = (/obj/structure/shuttle/engine/propulsion{icon_state = "propulsion_r"},/turf/space,/area/space)

(1,1,1) = {"
aaaaaaaaaaabacadadadaeafaaaaaaaaaa
aaaaaaaaabagahaiajakalagafaaaaaaaa
aaaaaaaaagamananaoananakagaaaaaaaa
aaaaaaaaagapananananaqakagaaaaaaaa
aaaaaaaaagarananasananatagaaaaaaaa
aaaaaaaaauagavagagagagagawaaaaaaaa
aaaaaaaaaaagaxayaqazaAagaaaaaaaaaa
aaaaaaaaaaagaBaCaqanaDagaaaaaaaaaa
aaaaaaaaabagaBayaqanaDagafaaaaaaaa
aaabagagagagaEayaqanaDagagagagafaa
aaagaFaGaHaganaIanaJagagaKaLaMaNaa
aaaOaPaQaPagagagaRagagaSaKaTaUaNaa
aaagagaOaVagagananaWagagaXaYaXagaa
aaaganananaZaganananagbabbbcbdagaa
aaagbeanananbfanananbganananbhagaa
aaagbianananbjanananbkanananblagaa
abagagagagagaganananagagagagagagaf
agbmbnbobpbqagbrananagbsbsbsbtbtag
bubvbvbvbvbvaganananagbranananbwbx
bybzbAbvbvbvbBanananbCanananbDbEbF
bGbvbvbvbvbvbHanananbIananananbJbK
agbLbvbvbvbMagaXbNaXagbObObPanbQag
agbRbSbTbUbVagbWanbXagbYagagbZagag
agcabvcbccagaganancdagagagananceag
agcfcgchagaaagciciciagaaaganananag
agciciciagaaaucjckclawaaagciciciag
aucjckclawaaaaaaaaaaaaaaaucjckclaw
"}
