"aa" = (/turf/space,/area/space)
"ab" = (/turf/simulated/shuttle/wall{dir = 8; icon_state = "diagonalWall3"},/area/syndicate_mothership/shuttle)
"ac" = (/turf/simulated/shuttle/wall{icon_state = "wall3"},/area/syndicate_mothership/shuttle)
"ad" = (/turf/simulated/shuttle/wall{dir = 1; icon_state = "diagonalWall3"},/area/syndicate_mothership/shuttle)
"ae" = (/obj/structure/table,/obj/item/weapon/bonesetter,/obj/item/weapon/bonegel,/turf/simulated/shuttle/floor{icon_state = "floor3"},/area/syndicate_mothership/shuttle)
"af" = (/obj/machinery/optable,/turf/simulated/shuttle/floor{icon_state = "floor3"},/area/syndicate_mothership/shuttle)
"ag" = (/obj/structure/table,/obj/item/stack/medical/advanced/bruise_pack,/obj/item/weapon/retractor,/turf/simulated/shuttle/floor{icon_state = "floor3"},/area/syndicate_mothership/shuttle)
"ah" = (/obj/structure/closet,/turf/simulated/shuttle/floor{icon_state = "floor6"},/area/syndicate_mothership/shuttle)
"ai" = (/turf/simulated/shuttle/floor{icon_state = "floor6"},/area/syndicate_mothership/shuttle)
"aj" = (/obj/structure/table,/obj/item/weapon/scalpel,/obj/item/weapon/circular_saw{pixel_y = 8},/turf/simulated/shuttle/floor{icon_state = "floor3"},/area/syndicate_mothership/shuttle)
"ak" = (/turf/simulated/shuttle/floor{icon_state = "floor3"},/area/syndicate_mothership/shuttle)
"al" = (/obj/structure/sink{dir = 4; icon_state = "sink"; pixel_x = 11; pixel_y = 0},/obj/item/device/radio/intercom{desc = "Talk through this. Evilly"; freerange = 1; frequency = 1213; name = "Syndicate Intercom"; pixel_x = 32; subspace_transmission = 1; syndie = 1},/turf/simulated/shuttle/floor{icon_state = "floor3"},/area/syndicate_mothership/shuttle)
"am" = (/obj/item/device/radio/intercom{desc = "Talk through this. Evilly"; freerange = 1; frequency = 1213; name = "Syndicate Intercom"; pixel_x = 32; subspace_transmission = 1; syndie = 1},/obj/item/weapon/stool{pixel_y = 8},/turf/simulated/shuttle/floor{icon_state = "floor6"},/area/syndicate_mothership/shuttle)
"an" = (/turf/space,/area/syndicate_mothership/shuttle)
"ao" = (/obj/structure/table,/obj/item/weapon/cautery,/obj/item/weapon/hemostat,/turf/simulated/shuttle/floor{icon_state = "floor3"},/area/syndicate_mothership/shuttle)
"ap" = (/obj/structure/closet/secure_closet/medical_wall{pixel_x = 30; pixel_y = 0; req_access = null; req_access_txt = "150"},/obj/item/weapon/surgicaldrill,/obj/item/clothing/gloves/latex,/obj/item/clothing/mask/surgical,/obj/item/weapon/reagent_containers/glass/bottle/stoxin,/obj/item/weapon/reagent_containers/glass/bottle/stoxin,/obj/item/weapon/reagent_containers/syringe,/turf/simulated/shuttle/floor{icon_state = "floor3"},/area/syndicate_mothership/shuttle)
"aq" = (/obj/structure/window/reinforced{dir = 1},/obj/machinery/door_control{id = "syndieshutters_infirmary"; name = "remote shutter control"; pixel_x = -25; req_access_txt = "0"},/turf/simulated/shuttle/floor{icon_state = "floor3"},/area/syndicate_mothership/shuttle)
"ar" = (/obj/machinery/door/window{dir = 1; name = "Surgery"; req_access_txt = "150"},/turf/simulated/shuttle/floor{icon_state = "floor3"},/area/syndicate_mothership/shuttle)
"as" = (/obj/structure/window/reinforced{dir = 1},/obj/structure/mopbucket,/turf/simulated/shuttle/floor{icon_state = "floor3"},/area/syndicate_mothership/shuttle)
"at" = (/obj/machinery/door/airlock/centcom{name = "Clothing Storage"; req_access_txt = "150"},/turf/simulated/shuttle/floor{icon_state = "floor6"},/area/syndicate_mothership/shuttle)
"au" = (/obj/structure/window/reinforced{dir = 1},/obj/structure/window/reinforced{dir = 8},/obj/structure/window/reinforced{dir = 4},/obj/structure/grille,/obj/machinery/door/blast/shutters{density = 0; dir = 8; icon_state = "shutter0"; id = "syndieshutters_infirmary"; name = "Blast Shutters"; opacity = 0},/turf/simulated/shuttle/plating,/area/syndicate_mothership/shuttle)
"av" = (/obj/machinery/sleeper,/turf/simulated/shuttle/floor{icon_state = "floor3"},/area/syndicate_mothership/shuttle)
"aw" = (/obj/machinery/sleep_console,/turf/simulated/shuttle/floor{icon_state = "floor3"},/area/syndicate_mothership/shuttle)
"ax" = (/obj/machinery/portable_atmospherics/canister/oxygen,/turf/simulated/shuttle/floor{icon_state = "floor3"},/area/syndicate_mothership/shuttle)
"ay" = (/obj/structure/grille,/obj/structure/window/reinforced,/obj/structure/window/reinforced{dir = 1},/obj/structure/window/reinforced{dir = 8},/obj/machinery/door/blast/shutters{density = 0; icon_state = "shutter0"; id = "syndieshutters"; name = "Blast Shutters"; opacity = 0},/turf/simulated/shuttle/plating,/area/syndicate_mothership/shuttle)
"az" = (/obj/structure/grille,/obj/structure/window/reinforced,/obj/structure/window/reinforced{dir = 1},/obj/machinery/door/blast/shutters{density = 0; icon_state = "shutter0"; id = "syndieshutters"; name = "Blast Shutters"; opacity = 0},/turf/simulated/shuttle/plating,/area/syndicate_mothership/shuttle)
"aA" = (/obj/structure/grille,/obj/structure/window/reinforced,/obj/structure/window/reinforced{dir = 1},/obj/structure/window/reinforced{dir = 4},/obj/machinery/door/blast/shutters{density = 0; icon_state = "shutter0"; id = "syndieshutters"; name = "Blast Shutters"; opacity = 0},/turf/simulated/shuttle/plating,/area/syndicate_mothership/shuttle)
"aB" = (/obj/structure/bed/chair,/turf/simulated/shuttle/floor{icon_state = "floor3"},/area/syndicate_mothership/shuttle)
"aC" = (/obj/structure/table,/obj/machinery/microwave{pixel_x = -1; pixel_y = 2},/turf/simulated/shuttle/floor{icon_state = "floor3"},/area/syndicate_mothership/shuttle)
"aD" = (/obj/structure/window/reinforced,/obj/structure/window/reinforced{dir = 8},/obj/structure/window/reinforced{dir = 4},/obj/structure/grille,/obj/machinery/door/blast/shutters{density = 0; dir = 8; icon_state = "shutter0"; id = "syndieshutters_infirmary"; name = "Blast Shutters"; opacity = 0},/turf/simulated/shuttle/plating,/area/syndicate_mothership/shuttle)
"aE" = (/obj/structure/table,/obj/structure/closet/secure_closet/medical_wall{pixel_x = 30; pixel_y = 0; req_access = null; req_access_txt = "150"},/obj/item/bodybag,/obj/item/weapon/reagent_containers/syringe/antiviral,/obj/item/weapon/reagent_containers/syringe/antiviral,/obj/item/weapon/reagent_containers/syringe/antiviral,/obj/item/weapon/reagent_containers/glass/bottle/antitoxin{pixel_x = -4; pixel_y = 8},/obj/item/weapon/reagent_containers/glass/bottle/inaprovaline{pixel_x = 4; pixel_y = 7},/obj/item/weapon/reagent_containers/syringe,/turf/simulated/shuttle/floor{icon_state = "floor3"},/area/syndicate_mothership/shuttle)
"aF" = (/obj/machinery/computer/security/nuclear,/turf/simulated/shuttle/floor{icon_state = "floor6"},/area/syndicate_mothership/shuttle)
"aG" = (/obj/machinery/computer/shuttle_control/multi/syndicate{req_access_txt = "0"},/turf/simulated/shuttle/floor{icon_state = "floor6"},/area/syndicate_mothership/shuttle)
"aH" = (/obj/structure/table,/obj/machinery/door_control{id = "syndieshutters"; name = "remote shutter control"; req_access_txt = "150"},/turf/simulated/shuttle/floor{icon_state = "floor6"},/area/syndicate_mothership/shuttle)
"aI" = (/obj/structure/table,/turf/simulated/shuttle/floor{icon_state = "floor3"},/area/syndicate_mothership/shuttle)
"aJ" = (/obj/item/device/radio/intercom{desc = "Talk through this. Evilly"; freerange = 1; frequency = 1213; name = "Syndicate Intercom"; pixel_x = 32; subspace_transmission = 1; syndie = 1},/obj/structure/table,/obj/item/weapon/storage/box/donkpockets{pixel_x = 2; pixel_y = 3},/turf/simulated/shuttle/floor{icon_state = "floor3"},/area/syndicate_mothership/shuttle)
"aK" = (/obj/machinery/bodyscanner,/turf/simulated/shuttle/floor{icon_state = "floor3"},/area/syndicate_mothership/shuttle)
"aL" = (/obj/machinery/body_scanconsole,/turf/simulated/shuttle/floor{icon_state = "floor3"},/area/syndicate_mothership/shuttle)
"aM" = (/obj/structure/table,/obj/item/roller{pixel_y = 8},/turf/simulated/shuttle/floor{icon_state = "floor3"},/area/syndicate_mothership/shuttle)
"aN" = (/obj/structure/bed/chair{dir = 1},/turf/simulated/shuttle/floor{icon_state = "floor6"},/area/syndicate_mothership/shuttle)
"aO" = (/obj/structure/table,/obj/machinery/recharger,/turf/simulated/shuttle/floor{icon_state = "floor6"},/area/syndicate_mothership/shuttle)
"aP" = (/obj/structure/bed/chair{dir = 1},/turf/simulated/shuttle/floor{icon_state = "floor3"},/area/syndicate_mothership/shuttle)
"aQ" = (/obj/structure/table,/obj/item/stack/sheet/glass{amount = 15},/obj/item/weapon/cell{charge = 100; maxcharge = 15000},/turf/simulated/shuttle/floor{icon_state = "floor3"},/area/syndicate_mothership/shuttle)
"aR" = (/obj/machinery/door/airlock/centcom{name = "Medbay"; req_access_txt = "150"},/turf/simulated/shuttle/floor{icon_state = "floor3"},/area/syndicate_mothership/shuttle)
"aS" = (/obj/item/device/radio/intercom{desc = "Talk through this. Evilly"; freerange = 1; frequency = 1213; name = "Syndicate Intercom"; pixel_y = -32; subspace_transmission = 1; syndie = 1},/turf/simulated/shuttle/floor{icon_state = "floor6"},/area/syndicate_mothership/shuttle)
"aT" = (/obj/machinery/door/airlock/centcom{name = "Break Room"; req_access_txt = "150"},/turf/simulated/shuttle/floor{icon_state = "floor3"},/area/syndicate_mothership/shuttle)
"aU" = (/obj/structure/toilet{dir = 4},/turf/simulated/shuttle/floor{icon_state = "floor7"},/area/syndicate_mothership/shuttle)
"aV" = (/obj/item/weapon/cigbutt,/turf/simulated/shuttle/floor{icon_state = "floor7"},/area/syndicate_mothership/shuttle)
"aW" = (/obj/structure/table,/obj/item/weapon/kitchen/utensil/knife{pixel_x = -6},/obj/item/weapon/reagent_containers/syringe/drugs{pixel_x = 3; pixel_y = -1},/obj/item/weapon/reagent_containers/syringe/drugs{pixel_x = 3; pixel_y = 4},/obj/item/weapon/reagent_containers/syringe/drugs{pixel_x = 3; pixel_y = 9},/obj/structure/sign/nosmoking_1{pixel_y = 32},/turf/simulated/shuttle/floor{icon_state = "floor6"},/area/syndicate_mothership/shuttle)
"aX" = (/obj/machinery/door/airlock/centcom{name = "Bridge"; req_access_txt = "150"},/turf/simulated/shuttle/floor{icon_state = "floor6"},/area/syndicate_mothership/shuttle)
"aY" = (/obj/structure/table,/obj/item/weapon/screwdriver,/obj/effect/spawner/newbomb/timer/syndicate,/turf/simulated/shuttle/floor{icon_state = "floor6"},/area/syndicate_mothership/shuttle)
"aZ" = (/obj/structure/table,/obj/item/clothing/gloves/yellow,/obj/item/device/assembly/signaler{pixel_y = 2},/obj/item/clothing/glasses/night,/turf/simulated/shuttle/floor{icon_state = "floor6"},/area/syndicate_mothership/shuttle)
"ba" = (/obj/structure/table,/obj/item/clothing/gloves/yellow,/obj/item/device/assembly/signaler{pixel_y = 2},/obj/item/clothing/glasses/night,/obj/machinery/door_control{id = "syndieshutters_workshop"; name = "remote shutter control"; pixel_x = 0; pixel_y = 25; req_access_txt = "0"},/turf/simulated/shuttle/floor{icon_state = "floor6"},/area/syndicate_mothership/shuttle)
"bb" = (/obj/structure/window/reinforced{dir = 1},/obj/structure/window/reinforced{dir = 8},/obj/structure/window/reinforced{dir = 4},/obj/structure/grille,/obj/machinery/door/blast/shutters{density = 0; dir = 4; icon_state = "shutter0"; id = "syndieshutters_workshop"; name = "Blast Shutters"; opacity = 0},/turf/simulated/shuttle/plating,/area/syndicate_mothership/shuttle)
"bc" = (/obj/structure/window/reinforced{dir = 4},/obj/structure/window/reinforced{dir = 8},/obj/structure/grille,/obj/structure/window/reinforced{dir = 1},/obj/structure/window/reinforced,/turf/unsimulated/floor{icon_state = "floor5"},/area/syndicate_mothership/shuttle)
"bd" = (/turf/simulated/shuttle/floor{icon_state = "floor7"},/area/syndicate_mothership/shuttle)
"be" = (/obj/machinery/door/window/westleft{name = "cell"; req_access_txt = "150"},/turf/simulated/shuttle/floor{icon_state = "floor6"},/area/syndicate_mothership/shuttle)
"bf" = (/obj/structure/closet/secure_closet/medical_wall{pixel_x = 0; pixel_y = 32; req_access = null; req_access_txt = "150"},/obj/item/stack/medical/splint,/obj/item/stack/medical/ointment,/obj/item/stack/medical/ointment,/obj/item/stack/medical/bruise_pack,/obj/item/stack/medical/bruise_pack,/obj/item/stack/medical/bruise_pack,/obj/item/weapon/storage/belt/medical,/obj/item/weapon/storage/belt/medical,/turf/simulated/shuttle/floor{icon_state = "floor6"},/area/syndicate_mothership/shuttle)
"bg" = (/obj/machinery/suit_cycler/syndicate{locked = 0},/turf/simulated/shuttle/floor{icon_state = "floor6"},/area/syndicate_mothership/shuttle)
"bh" = (/obj/item/weapon/stool{pixel_y = 8},/turf/simulated/shuttle/floor{icon_state = "floor6"},/area/syndicate_mothership/shuttle)
"bi" = (/obj/structure/table,/obj/item/clothing/gloves/yellow,/obj/item/device/assembly/prox_sensor{pixel_x = -8; pixel_y = 4},/obj/item/clothing/glasses/night,/turf/simulated/shuttle/floor{icon_state = "floor6"},/area/syndicate_mothership/shuttle)
"bj" = (/obj/structure/window/reinforced{dir = 8},/obj/structure/window/reinforced{dir = 4},/obj/structure/grille,/obj/machinery/door/blast/shutters{density = 0; dir = 4; icon_state = "shutter0"; id = "syndieshutters_workshop"; name = "Blast Shutters"; opacity = 0},/turf/simulated/shuttle/plating,/area/syndicate_mothership/shuttle)
"bk" = (/obj/item/device/radio/electropack,/turf/simulated/shuttle/floor{icon_state = "floor7"},/area/syndicate_mothership/shuttle)
"bl" = (/obj/item/device/radio/intercom{desc = "Talk through this. Evilly"; freerange = 1; frequency = 1213; name = "Syndicate Intercom"; pixel_x = -32; subspace_transmission = 1; syndie = 1},/turf/simulated/shuttle/floor{icon_state = "floor6"},/area/syndicate_mothership/shuttle)
"bm" = (/obj/structure/closet/syndicate/suit{name = "suit closet"},/turf/simulated/shuttle/floor{icon_state = "floor6"},/area/syndicate_mothership/shuttle)
"bn" = (/obj/structure/table,/obj/item/weapon/screwdriver,/obj/effect/spawner/newbomb/timer/syndicate,/obj/item/device/aicard,/turf/simulated/shuttle/floor{icon_state = "floor6"},/area/syndicate_mothership/shuttle)
"bo" = (/obj/structure/window/reinforced,/obj/structure/window/reinforced{dir = 8},/obj/structure/window/reinforced{dir = 4},/obj/structure/grille,/obj/machinery/door/blast/shutters{density = 0; dir = 4; icon_state = "shutter0"; id = "syndieshutters_workshop"; name = "Blast Shutters"; opacity = 0},/turf/simulated/shuttle/plating,/area/syndicate_mothership/shuttle)
"bp" = (/obj/machinery/access_button{command = "cycle_interior"; frequency = 1331; master_tag = "synd_airlock2"; name = "interior access button"; pixel_x = -25; pixel_y = -10; req_access_txt = "0"},/turf/simulated/shuttle/floor{icon_state = "floor6"},/area/syndicate_mothership/shuttle)
"bq" = (/obj/structure/table/rack,/obj/item/weapon/storage/belt/security,/obj/item/weapon/storage/belt/security,/turf/simulated/shuttle/floor{icon_state = "floor6"},/area/syndicate_mothership/shuttle)
"br" = (/obj/machinery/door/airlock/centcom{name = "Tool Storage"; req_access_txt = "150"},/turf/simulated/shuttle/floor{icon_state = "floor6"},/area/syndicate_mothership/shuttle)
"bs" = (/obj/machinery/door/airlock/external{frequency = 1331; icon_state = "door_closed"; id_tag = "synd_outer2"; locked = 0; name = "Ship External Access"; req_access = null; req_access_txt = "150"},/obj/machinery/door/blast/regular{density = 0; icon_state = "pdoor0"; id = "smindicate"; name = "Outer Airlock"; opacity = 0},/turf/simulated/shuttle/floor{icon_state = "floor6"},/area/syndicate_mothership/shuttle)
"bt" = (/obj/machinery/airlock_sensor{frequency = 1331; id_tag = "synd_sensor2"; pixel_x = 8; pixel_y = 25},/turf/simulated/shuttle/floor{icon_state = "floor6"},/area/syndicate_mothership/shuttle)
"bu" = (/obj/machinery/atmospherics/unary/vent_pump/high_volume{dir = 4; frequency = 1331; id_tag = "synd_pump2"},/obj/machinery/embedded_controller/radio/airlock/airlock_controller{frequency = 1331; id_tag = "synd_airlock2"; pixel_x = -8; pixel_y = 25; req_access_txt = "0"; tag_airpump = "synd_pump2"; tag_chamber_sensor = "synd_sensor2"; tag_exterior_door = "synd_outer2"; tag_interior_door = "synd_inner2"},/turf/simulated/shuttle/floor{icon_state = "floor6"},/area/syndicate_mothership/shuttle)
"bv" = (/obj/machinery/atmospherics/pipe/simple/visible{tag = "icon-intact (SOUTHWEST)"; icon_state = "intact"; dir = 10},/obj/machinery/door/airlock/external{frequency = 1331; icon_state = "door_closed"; id_tag = "synd_inner2"; locked = 0; name = "Ship External Access"; req_access = null; req_access_txt = "0"},/turf/simulated/shuttle/floor{icon_state = "floor6"},/area/syndicate_mothership/shuttle)
"bw" = (/obj/machinery/door/window{base_state = "right"; dir = 8; icon_state = "right"; name = "Preparation"; req_access_txt = "150"},/turf/simulated/shuttle/floor{icon_state = "floor6"},/area/syndicate_mothership/shuttle)
"bx" = (/obj/structure/closet/hydrant{pixel_y = 32},/turf/simulated/shuttle/floor{icon_state = "floor6"},/area/syndicate_mothership/shuttle)
"by" = (/obj/machinery/door/airlock/external{frequency = 1331; icon_state = "door_closed"; id_tag = "synd_inner"; locked = 0; name = "Ship External Access"; req_access = null; req_access_txt = "0"},/obj/machinery/atmospherics/pipe/simple/visible{icon_state = "intact"; dir = 6},/turf/simulated/shuttle/floor{icon_state = "floor6"},/area/syndicate_mothership/shuttle)
"bz" = (/obj/machinery/atmospherics/unary/vent_pump/high_volume{dir = 8; frequency = 1331; id_tag = "synd_pump"},/obj/machinery/airlock_sensor{frequency = 1331; id_tag = "synd_sensor"; pixel_x = 8; pixel_y = 25},/turf/simulated/shuttle/floor{icon_state = "floor6"},/area/syndicate_mothership/shuttle)
"bA" = (/obj/machinery/embedded_controller/radio/airlock/airlock_controller{frequency = 1331; id_tag = "synd_airlock"; pixel_x = -8; pixel_y = 25; req_access_txt = "0"; tag_airpump = "synd_pump"; tag_chamber_sensor = "synd_sensor"; tag_exterior_door = "synd_outer"; tag_interior_door = "synd_inner"},/turf/simulated/shuttle/floor{icon_state = "floor6"},/area/syndicate_mothership/shuttle)
"bB" = (/obj/machinery/door/airlock/external{frequency = 1331; icon_state = "door_closed"; id_tag = "synd_outer"; locked = 0; name = "Ship External Access"; req_access = null; req_access_txt = "150"},/obj/machinery/door/blast/regular{density = 0; icon_state = "pdoor0"; id = "smindicate"; name = "Outer Airlock"; opacity = 0},/turf/simulated/shuttle/floor{icon_state = "floor6"},/area/syndicate_mothership/shuttle)
"bC" = (/obj/machinery/atmospherics/unary/vent_pump/high_volume{dir = 4; frequency = 1331; id_tag = "synd_pump2"},/turf/simulated/shuttle/floor{icon_state = "floor6"},/area/syndicate_mothership/shuttle)
"bD" = (/obj/machinery/atmospherics/pipe/manifold/visible,/obj/machinery/door/airlock/external{frequency = 1331; icon_state = "door_closed"; id_tag = "synd_inner2"; locked = 0; name = "Ship External Access"; req_access = null; req_access_txt = "0"},/turf/simulated/shuttle/floor{icon_state = "floor6"},/area/syndicate_mothership/shuttle)
"bE" = (/obj/machinery/atmospherics/pipe/simple/visible{tag = "icon-intact (SOUTHWEST)"; icon_state = "intact"; dir = 10},/turf/simulated/shuttle/floor{icon_state = "floor6"},/area/syndicate_mothership/shuttle)
"bF" = (/obj/structure/table,/obj/item/weapon/storage/firstaid/toxin{pixel_x = 3; pixel_y = 3},/obj/item/weapon/storage/firstaid/adv{pixel_x = 1},/turf/simulated/shuttle/floor{icon_state = "floor6"},/area/syndicate_mothership/shuttle)
"bG" = (/obj/structure/table,/obj/item/weapon/storage/firstaid/o2{pixel_x = 3; pixel_y = 3},/obj/item/weapon/storage/firstaid/fire{pixel_x = 1},/turf/simulated/shuttle/floor{icon_state = "floor6"},/area/syndicate_mothership/shuttle)
"bH" = (/obj/machinery/door/window{base_state = "left"; dir = 8; icon_state = "left"; name = "Preparation"; req_access_txt = "150"},/turf/simulated/shuttle/floor{icon_state = "floor6"},/area/syndicate_mothership/shuttle)
"bI" = (/obj/machinery/atmospherics/pipe/simple/visible{icon_state = "intact"; dir = 6},/turf/simulated/shuttle/floor{icon_state = "floor6"},/area/syndicate_mothership/shuttle)
"bJ" = (/obj/machinery/door/airlock/external{frequency = 1331; icon_state = "door_closed"; id_tag = "synd_inner"; locked = 0; name = "Ship External Access"; req_access = null; req_access_txt = "0"},/obj/machinery/atmospherics/pipe/simple/visible{dir = 4},/obj/machinery/atmospherics/pipe/manifold/visible,/turf/simulated/shuttle/floor{icon_state = "floor6"},/area/syndicate_mothership/shuttle)
"bK" = (/obj/machinery/atmospherics/unary/vent_pump/high_volume{dir = 8; frequency = 1331; id_tag = "synd_pump"},/turf/simulated/shuttle/floor{icon_state = "floor6"},/area/syndicate_mothership/shuttle)
"bL" = (/obj/machinery/door/airlock/centcom{name = "Tool Storage"; req_access_txt = "150"},/obj/machinery/atmospherics/pipe/simple/visible,/turf/simulated/shuttle/floor{icon_state = "floor6"},/area/syndicate_mothership/shuttle)
"bM" = (/obj/structure/bed/chair{dir = 4},/obj/machinery/recharger/wallcharger{pixel_x = -25},/turf/simulated/shuttle/floor{icon_state = "floor6"},/area/syndicate_mothership/shuttle)
"bN" = (/obj/structure/bed/chair{dir = 8},/turf/simulated/shuttle/floor{icon_state = "floor6"},/area/syndicate_mothership/shuttle)
"bO" = (/obj/machinery/atmospherics/pipe/simple/visible,/obj/machinery/access_button{command = "cycle_interior"; frequency = 1331; master_tag = "synd_airlock"; name = "interior access button"; pixel_x = 25; pixel_y = 10; req_access_txt = "0"},/turf/simulated/shuttle/floor{icon_state = "floor6"},/area/syndicate_mothership/shuttle)
"bP" = (/turf/simulated/shuttle/wall{icon_state = "diagonalWall3"},/area/syndicate_mothership/shuttle)
"bQ" = (/obj/machinery/atmospherics/pipe/tank/air{dir = 4; start_pressure = 740.5},/turf/simulated/shuttle/floor{icon_state = "floor6"},/area/syndicate_mothership/shuttle)
"bR" = (/obj/machinery/atmospherics/pipe/manifold/visible{dir = 1},/turf/simulated/shuttle/floor{icon_state = "floor6"},/area/syndicate_mothership/shuttle)
"bS" = (/obj/machinery/atmospherics/pipe/simple/visible{tag = "icon-intact (NORTHWEST)"; icon_state = "intact"; dir = 9},/turf/simulated/shuttle/floor{icon_state = "floor6"},/area/syndicate_mothership/shuttle)
"bT" = (/obj/structure/table,/obj/machinery/computer/pod/old/syndicate{id = "smindicate"},/turf/simulated/shuttle/floor{icon_state = "floor6"},/area/syndicate_mothership/shuttle)
"bU" = (/obj/structure/bed/chair{dir = 8},/obj/structure/closet/walllocker/emerglocker{pixel_x = 28},/turf/simulated/shuttle/floor{icon_state = "floor6"},/area/syndicate_mothership/shuttle)
"bV" = (/obj/machinery/atmospherics/pipe/simple/visible{tag = "icon-intact (NORTHEAST)"; icon_state = "intact"; dir = 5},/turf/simulated/shuttle/floor{icon_state = "floor6"},/area/syndicate_mothership/shuttle)
"bW" = (/obj/machinery/atmospherics/pipe/tank/air{dir = 8},/obj/structure/sign/securearea{name = "\improper CAUTION"; pixel_x = 32},/turf/simulated/shuttle/floor{icon_state = "floor6"},/area/syndicate_mothership/shuttle)
"bX" = (/turf/simulated/shuttle/wall{dir = 4; icon_state = "diagonalWall3"},/area/syndicate_mothership/shuttle)
"bY" = (/obj/machinery/vending/assist{contraband = null; name = "AntagCorpVent"; products = list(/obj/item/device/assembly/prox_sensor = 5, /obj/item/device/assembly/signaler = 4, /obj/item/device/assembly/infra = 4, /obj/item/device/assembly/prox_sensor = 4, /obj/item/weapon/handcuffs = 8, /obj/item/device/flash = 4, /obj/item/weapon/cartridge/signal = 4)},/obj/item/device/radio/intercom{desc = "Talk through this. Evilly"; freerange = 1; frequency = 1213; name = "Syndicate Intercom"; pixel_x = 32; subspace_transmission = 1; syndie = 1},/turf/simulated/shuttle/floor{icon_state = "floor6"},/area/syndicate_mothership/shuttle)
"bZ" = (/obj/structure/bed/chair{dir = 4},/obj/structure/sign/poster{poster_type = "/datum/poster/bay_50"; pixel_x = -32},/turf/simulated/shuttle/floor{icon_state = "floor6"},/area/syndicate_mothership/shuttle)
"ca" = (/obj/machinery/telecomms/allinone{intercept = 1},/obj/machinery/door/window/northright{name = "Telecoms Mainframe"; req_access_txt = "150"},/turf/simulated/shuttle/floor{icon_state = "floor6"},/area/syndicate_mothership/shuttle)
"cb" = (/obj/structure/window/reinforced{dir = 8},/turf/simulated/shuttle/floor{icon_state = "floor6"},/area/syndicate_mothership/shuttle)
"cc" = (/obj/machinery/door_control{id = "syndieshutters_telebay"; name = "remote shutter control"; pixel_x = 0; pixel_y = -25; req_access_txt = "150"},/obj/machinery/atmospherics/pipe/simple/visible{tag = "icon-intact (NORTHEAST)"; icon_state = "intact"; dir = 5},/turf/simulated/shuttle/floor{icon_state = "floor6"},/area/syndicate_mothership/shuttle)
"cd" = (/obj/machinery/atmospherics/pipe/tank/air{dir = 8},/turf/simulated/shuttle/floor{icon_state = "floor6"},/area/syndicate_mothership/shuttle)
"ce" = (/obj/machinery/door/blast/regular{id = "syndieshutters_telebay"; name = "Outer Airlock"},/turf/simulated/shuttle/floor{icon_state = "floor6"},/area/syndicate_mothership/shuttle)
"cf" = (/obj/structure/table/rack,/obj/item/weapon/storage/belt/utility/full,/obj/item/device/multitool,/turf/simulated/shuttle/floor{icon_state = "floor6"},/area/syndicate_mothership/shuttle)
"cg" = (/obj/item/device/radio/intercom{desc = "Talk through this. Evilly"; freerange = 1; frequency = 1213; name = "Syndicate Intercom"; pixel_x = 32; subspace_transmission = 1; syndie = 1},/turf/simulated/shuttle/floor{icon_state = "floor6"},/area/syndicate_mothership/shuttle)
"ch" = (/obj/structure/table/rack,/obj/item/weapon/handcuffs,/obj/item/weapon/handcuffs,/turf/simulated/shuttle/floor{icon_state = "floor7"},/area/syndicate_mothership/shuttle)
"ci" = (/obj/structure/sign/nosmoking_2{pixel_x = 32},/obj/structure/table,/obj/item/clothing/glasses/sunglasses/blindfold,/turf/simulated/shuttle/floor{icon_state = "floor7"},/area/syndicate_mothership/shuttle)
"cj" = (/obj/item/weapon/storage/toolbox/syndicate{pixel_x = -1; pixel_y = 3},/turf/simulated/shuttle/floor{icon_state = "floor6"},/area/syndicate_mothership/shuttle)
"ck" = (/obj/structure/closet{name = "custodial"},/obj/item/weapon/reagent_containers/glass/bucket,/obj/item/weapon/mop,/obj/item/weapon/reagent_containers/spray/cleaner,/turf/simulated/shuttle/floor{icon_state = "floor6"},/area/syndicate_mothership/shuttle)
"cl" = (/obj/structure/table/rack,/obj/item/weapon/coin/gold,/turf/simulated/shuttle/floor{icon_state = "floor7"},/area/syndicate_mothership/shuttle)
"cm" = (/obj/structure/table,/obj/item/clothing/mask/muzzle,/turf/simulated/shuttle/floor{icon_state = "floor7"},/area/syndicate_mothership/shuttle)
"cn" = (/obj/structure/shuttle/engine/heater,/obj/structure/window/reinforced{dir = 1},/turf/simulated/floor/plating/airless,/area/syndicate_mothership/shuttle)
"co" = (/obj/structure/shuttle/engine/propulsion{icon_state = "propulsion_r"},/turf/simulated/floor/plating,/area/syndicate_mothership/shuttle)
"cp" = (/obj/structure/shuttle/engine/propulsion{icon_state = "propulsion_l"},/turf/simulated/floor/plating,/area/syndicate_mothership/shuttle)
"cq" = (/obj/structure/shuttle/engine/propulsion,/turf/simulated/floor/plating,/area/syndicate_mothership/shuttle)

(1,1,1) = {"
aaaaabacacacadaaaaaaabacacacadaaaa
aaaaacaeafagacaaaaaaacahaiaiacaaaa
aaaaacajakalacaaaaaaacahaiamacaaaa
aaanacaoakapacaaaaaaacahaiaiacanaa
aaabacaqarasacaaaaaaacacacatacadaa
aaauavawakaxacayazaAacaBaBakaCacaa
aaaDakakakaEacaFaGaHacaIaIakaJacaa
abacaKaLakaMacaiaNaOacaPaPakaQacad
acacacacaRacacaSaiaiacacacaTacacac
acaUaVacaiaWacacaXacacaYaiaiaZbabb
bcbdbdbeaiaibfaiaibgacaYaiaibhbibj
acbdbkbcblaiaiaiaibmacbnaiaiaibibo
acacacacbpaiaiaiaibqacacbracacacac
bsbtbubvaiaiaiaiaiaibwbxaibybzbAbB
bsaibCbDbEbFbGaiaiaibHaibIbJbKaibB
acacacacbLacacbMaibNacblbOacacacac
bPacbQbRbSbTacbMaibUacaibVbRbWacbX
aaacbQbSaibYacbZaibNaccacbcccdacaa
aaacacacbracacacacacacacceacacacaa
aaaccfaiaiaicgacaaacchbdbdbdciacaa
aaaccfcjaiaickacaaacclbdbdbdcmacaa
aaaccncncncncnacaaaccncncncncnacaa
aabPcococococobXaabPcpcqcococobXaa
"}
