"aa" = (/turf/space,/area/space)
"ab" = (/turf/simulated/shuttle/wall{dir = 8; icon_state = "diagonalWall3"},/area/adminprep/valansship)
"ac" = (/turf/simulated/shuttle/wall{icon_state = "wall3"},/area/adminprep/valansship)
"ad" = (/turf/simulated/shuttle/wall{dir = 1; icon_state = "diagonalWall3"},/area/adminprep/valansship)
"ae" = (/obj/structure/table,/obj/machinery/chem_dispenser/soda,/turf/simulated/shuttle/floor{tag = "icon-floor7"; icon_state = "floor7"},/area/adminprep/valansship)
"af" = (/obj/structure/table,/obj/machinery/chem_dispenser/beer,/turf/simulated/shuttle/floor{tag = "icon-floor7"; icon_state = "floor7"},/area/adminprep/valansship)
"ag" = (/obj/structure/bookcase{name = "bookcase (Adult)"},/turf/simulated/shuttle/floor{icon_state = "floor3"},/area/adminprep/valansship)
"ah" = (/obj/machinery/shower{icon_state = "shower"; dir = 8},/obj/structure/curtain/open/shower,/turf/simulated/shuttle/floor{icon_state = "floor3"},/area/adminprep/valansship)
"ai" = (/turf/simulated/shuttle/floor{tag = "icon-floor7"; icon_state = "floor7"},/area/adminprep/valansship)
"aj" = (/obj/structure/toilet{dir = 4},/turf/simulated/shuttle/floor{icon_state = "floor3"},/area/adminprep/valansship)
"ak" = (/obj/structure/mirror{dir = 4; pixel_x = 25; pixel_y = 0},/obj/structure/sink{dir = 4; icon_state = "sink"; pixel_x = 11; pixel_y = 0},/turf/simulated/shuttle/floor{icon_state = "floor3"},/area/adminprep/valansship)
"al" = (/obj/machinery/door/airlock/centcom{req_access_txt = "105"},/turf/simulated/shuttle/floor{tag = "icon-floor7"; icon_state = "floor7"},/area/adminprep/valansship)
"am" = (/obj/machinery/door/airlock/centcom{req_access_txt = "105"},/turf/simulated/shuttle/floor{icon_state = "floor3"},/area/adminprep/valansship)
"an" = (/obj/structure/window/reinforced{dir = 8},/obj/structure/window/reinforced{dir = 4},/obj/structure/grille,/obj/machinery/door/blast/shutters{density = 0; dir = 8; icon_state = "shutter0"; id = "syndieshutters_infirmary"; name = "Blast Shutters"; opacity = 0},/obj/structure/window/reinforced{dir = 1; maxhealth = 1.#INF},/turf/simulated/shuttle/plating,/area/adminprep/valansship)
"ao" = (/obj/machinery/door_control{id = "syndieshutters_infirmary"; name = "remote shutter control"; pixel_x = 0; pixel_y = 25; req_access_txt = "0"},/obj/machinery/microwave{pixel_x = -1; pixel_y = 2},/obj/structure/table,/turf/simulated/shuttle/floor{tag = "icon-floor7"; icon_state = "floor7"},/area/adminprep/valansship)
"ap" = (/obj/structure/table/woodentable,/obj/item/weapon/reagent_containers/food/drinks/shaker,/obj/item/weapon/storage/box/drinkingglasses,/obj/item/device/radio/intercom{name = "Station Intercom (General)"; pixel_y = 22},/turf/simulated/shuttle/floor{tag = "icon-floor7"; icon_state = "floor7"},/area/adminprep/valansship)
"aq" = (/obj/structure/filingcabinet,/turf/simulated/shuttle/floor{tag = "icon-floor7"; icon_state = "floor7"},/area/adminprep/valansship)
"ar" = (/obj/item/device/radio/intercom{name = "Station Intercom (General)"; pixel_y = 22},/turf/simulated/shuttle/floor{tag = "icon-floor7"; icon_state = "floor7"},/area/adminprep/valansship)
"as" = (/obj/structure/window/reinforced{dir = 8},/obj/structure/window/reinforced{dir = 4},/obj/structure/grille,/obj/machinery/door/blast/shutters{density = 0; dir = 8; icon_state = "shutter0"; id = "syndieshutters_infirmary"; name = "Blast Shutters"; opacity = 0},/turf/simulated/shuttle/plating,/area/adminprep/valansship)
"at" = (/obj/structure/table,/obj/item/weapon/storage/box/donkpockets{pixel_x = 2; pixel_y = 3},/turf/simulated/shuttle/floor{tag = "icon-floor7"; icon_state = "floor7"},/area/adminprep/valansship)
"au" = (/obj/structure/bed/chair/comfy/brown,/turf/simulated/shuttle/floor{tag = "icon-floor7"; icon_state = "floor7"},/area/adminprep/valansship)
"av" = (/obj/structure/window/reinforced{dir = 8},/obj/structure/window/reinforced{dir = 4},/obj/structure/grille,/obj/machinery/door/blast/shutters{density = 0; dir = 8; icon_state = "shutter0"; id = "syndieshutters_infirmary"; name = "Blast Shutters"; opacity = 0},/obj/structure/window/reinforced,/turf/simulated/shuttle/plating,/area/adminprep/valansship)
"aw" = (/obj/structure/table,/obj/item/weapon/cell/high{charge = 100; maxcharge = 15000},/turf/simulated/shuttle/floor{tag = "icon-floor7"; icon_state = "floor7"},/area/adminprep/valansship)
"ax" = (/obj/machinery/atmospherics/pipe/simple/hidden{dir = 6},/turf/simulated/shuttle/floor{tag = "icon-floor7"; icon_state = "floor7"},/area/adminprep/valansship)
"ay" = (/obj/machinery/atmospherics/pipe/tank/air{tag = "icon-air_map (WEST)"; icon_state = "air_map"; dir = 8; start_pressure = 740.5},/turf/simulated/floor/plating{icon_state = "warnplate"; dir = 9},/area/adminprep/valansship)
"az" = (/obj/structure/grille,/obj/structure/window/reinforced,/obj/structure/window/reinforced{dir = 1},/obj/structure/window/reinforced{tag = "icon-rwindow (WEST)"; icon_state = "rwindow"; dir = 8},/turf/simulated/shuttle/plating,/area/adminprep/valansship)
"aA" = (/obj/structure/grille,/obj/structure/window/reinforced,/obj/structure/window/reinforced{dir = 1},/turf/simulated/shuttle/plating,/area/adminprep/valansship)
"aB" = (/obj/structure/grille,/obj/structure/window/reinforced,/obj/structure/window/reinforced{dir = 1},/obj/structure/window/reinforced{dir = 4},/turf/simulated/shuttle/plating,/area/adminprep/valansship)
"aC" = (/obj/machinery/atmospherics/pipe/tank/air{dir = 4; start_pressure = 740.5},/turf/simulated/floor/plating{icon_state = "warnplate"; dir = 5},/area/adminprep/valansship)
"aD" = (/obj/machinery/atmospherics/pipe/simple/hidden{dir = 10; icon_state = "intact"; tag = "icon-intact-f (SOUTHWEST)"},/turf/simulated/shuttle/floor{tag = "icon-floor7"; icon_state = "floor7"},/area/adminprep/valansship)
"aE" = (/obj/structure/table/woodentable,/obj/item/weapon/paper_bin{pixel_x = -3; pixel_y = 8},/turf/simulated/shuttle/floor{tag = "icon-floor7"; icon_state = "floor7"},/area/adminprep/valansship)
"aF" = (/turf/simulated/shuttle/wall{icon_state = "diagonalWall3"},/area/adminprep/valansship)
"aG" = (/obj/machinery/atmospherics/pipe/simple/hidden,/turf/simulated/shuttle/floor{tag = "icon-floor7"; icon_state = "floor7"},/area/adminprep/valansship)
"aH" = (/obj/structure/closet/crate/medical,/obj/item/weapon/storage/firstaid/fire{pixel_x = 1},/obj/item/weapon/storage/firstaid/o2{pixel_x = 3; pixel_y = 3},/obj/item/weapon/storage/firstaid/toxin{pixel_x = 3; pixel_y = 3},/obj/item/weapon/storage/firstaid/adv{pixel_x = 1},/turf/simulated/floor/plating{icon_state = "warnplate"; dir = 8},/area/adminprep/valansship)
"aI" = (/obj/item/weapon/storage/toolbox/emergency,/obj/structure/table,/turf/simulated/shuttle/floor{tag = "icon-floor7"; icon_state = "floor7"},/area/adminprep/valansship)
"aJ" = (/obj/machinery/computer/shuttle_control/multi/syndicate{req_access = list(103); req_access_txt = "0"; shuttle_tag = "Valans"},/turf/simulated/shuttle/floor{tag = "icon-floor7"; icon_state = "floor7"},/area/adminprep/valansship)
"aK" = (/obj/machinery/portable_atmospherics/canister/oxygen,/turf/simulated/floor/plating{icon_state = "warnplate"; dir = 4},/area/adminprep/valansship)
"aL" = (/turf/simulated/shuttle/wall{dir = 4; icon_state = "diagonalWall3"},/area/adminprep/valansship)
"aM" = (/obj/machinery/access_button{command = "cycle_exterior"; frequency = 1379; layer = 3.3; master_tag = "monarch1_airlock"; name = "exterior access button"; pixel_x = 25; pixel_y = 25; req_access_txt = "0"},/turf/space,/area/space)
"aN" = (/obj/machinery/door/airlock/external{frequency = 1379; icon_state = "door_locked"; id_tag = "mornarch1_outer"; locked = 1; name = "External Airlock"; req_access = null; req_access_txt = "0"},/turf/simulated/floor/plating{icon_state = "warnplate"; dir = 8},/area/adminprep/valansship)
"aO" = (/obj/machinery/atmospherics/pipe/simple/visible{icon_state = "intact"; dir = 6},/turf/simulated/floor/plating,/area/adminprep/valansship)
"aP" = (/obj/machinery/door/airlock/external{frequency = 1379; icon_state = "door_locked"; id_tag = "mornarch1_inner"; locked = 1; name = "External Airlock"; req_access = null; req_access_txt = "0"},/obj/machinery/atmospherics/pipe/simple/visible{dir = 4},/turf/simulated/floor/plating{icon_state = "warnplate"; dir = 4},/area/adminprep/valansship)
"aQ" = (/obj/machinery/atmospherics/pipe/simple/hidden{dir = 9; icon_state = "intact"; tag = "icon-intact-f (NORTHWEST)"},/obj/machinery/access_button{command = "cycle_interior"; frequency = 1379; layer = 3.3; master_tag = "monarch1_airlock"; name = "interior access button"; pixel_x = -25; pixel_y = 25; req_access_txt = "13"},/turf/simulated/shuttle/floor{tag = "icon-floor7"; icon_state = "floor7"},/area/adminprep/valansship)
"aR" = (/turf/simulated/floor/plating{icon_state = "warnplate"; dir = 8},/area/adminprep/valansship)
"aS" = (/obj/item/device/radio/intercom{name = "Station Intercom (General)"; pixel_y = -28},/obj/structure/table,/obj/machinery/recharger/wallcharger{pixel_x = -27; pixel_y = -3},/obj/item/device/flashlight/lamp/green,/turf/simulated/shuttle/floor{tag = "icon-floor7"; icon_state = "floor7"},/area/adminprep/valansship)
"aT" = (/obj/structure/bed/chair/shuttle{tag = "icon-chair3 (NORTH)"; icon_state = "chair3"; dir = 1},/turf/simulated/shuttle/floor{tag = "icon-floor7"; icon_state = "floor7"},/area/adminprep/valansship)
"aU" = (/obj/structure/closet/emcloset,/obj/item/clothing/suit/space,/obj/item/clothing/mask/breath,/obj/item/weapon/tank/emergency_oxygen/engi,/obj/item/clothing/head/helmet/space,/obj/structure/sign/poster{poster_type = "/datum/poster/bay_50"; pixel_x = -32},/turf/simulated/floor/plating{icon_state = "warnplate"; dir = 4},/area/adminprep/valansship)
"aV" = (/obj/machinery/atmospherics/pipe/simple/hidden{dir = 5; icon_state = "intact"; tag = "icon-intact-f (NORTHEAST)"},/obj/machinery/access_button{command = "cycle_interior"; frequency = 1379; layer = 3.3; master_tag = "monarch2_airlock"; name = "interior access button"; pixel_x = 25; pixel_y = 25; req_access_txt = "13"},/turf/simulated/shuttle/floor{tag = "icon-floor7"; icon_state = "floor7"},/area/adminprep/valansship)
"aW" = (/obj/machinery/door/airlock/external{frequency = 1379; icon_state = "door_locked"; id_tag = "mornarch2_inner"; locked = 1; name = "External Airlock"; req_access = null; req_access_txt = "0"},/obj/machinery/atmospherics/pipe/simple/visible{dir = 4},/turf/simulated/floor/plating{icon_state = "warnplate"; dir = 8},/area/adminprep/valansship)
"aX" = (/obj/machinery/atmospherics/pipe/simple/visible{tag = "icon-intact (SOUTHWEST)"; icon_state = "intact"; dir = 10},/turf/simulated/floor/plating,/area/adminprep/valansship)
"aY" = (/obj/machinery/door/airlock/external{frequency = 1379; icon_state = "door_locked"; id_tag = "mornarch2_outer"; locked = 1; name = "External Airlock"; req_access = null; req_access_txt = "0"},/turf/simulated/floor/plating{icon_state = "warnplate"; dir = 4},/area/adminprep/valansship)
"aZ" = (/obj/machinery/access_button{command = "cycle_exterior"; frequency = 1379; layer = 3.3; master_tag = "monarch2_airlock"; name = "exterior access button"; pixel_x = -25; pixel_y = 25; req_access_txt = "0"},/turf/space,/area/space)
"ba" = (/obj/machinery/atmospherics/unary/vent_pump/high_volume{dir = 1; frequency = 1379; id_tag = "monarch1_pump"},/obj/machinery/embedded_controller/radio/airlock/airlock_controller{frequency = 1379; id_tag = "monarch1_airlock"; layer = 3.3; pixel_x = 0; pixel_y = -25; req_access_txt = "0"; tag_airpump = "monarch1_pump"; tag_chamber_sensor = "monarch1_sensor"; tag_exterior_door = "monarch1_outer"; tag_interior_door = "monarch1_inner"},/obj/machinery/airlock_sensor{frequency = 1379; id_tag = "monarch1_sensor"; layer = 3.3; pixel_x = 12; pixel_y = -25},/turf/simulated/floor/plating,/area/adminprep/valansship)
"bb" = (/obj/machinery/door/airlock/external{frequency = 1379; icon_state = "door_locked"; id_tag = "mornarch1_inner"; locked = 1; name = "External Airlock"; req_access = null; req_access_txt = "0"},/turf/simulated/floor/plating{icon_state = "warnplate"; dir = 4},/area/adminprep/valansship)
"bc" = (/turf/simulated/floor/plating{icon_state = "warnplate"; dir = 10},/area/adminprep/valansship)
"bd" = (/turf/simulated/floor/plating{icon_state = "warnplate"; dir = 6},/area/adminprep/valansship)
"be" = (/obj/machinery/door/airlock/external{frequency = 1379; icon_state = "door_locked"; id_tag = "mornarch2_inner"; locked = 1; name = "External Airlock"; req_access = null; req_access_txt = "0"},/turf/simulated/floor/plating{icon_state = "warnplate"; dir = 8},/area/adminprep/valansship)
"bf" = (/obj/machinery/atmospherics/unary/vent_pump/high_volume{dir = 1; frequency = 1379; id_tag = "monarch2_pump"},/obj/machinery/embedded_controller/radio/airlock/airlock_controller{frequency = 1379; id_tag = "monarch2_airlock"; layer = 3.3; pixel_x = 0; pixel_y = -25; req_access_txt = "0"; tag_airpump = "monarch2_pump"; tag_chamber_sensor = "monarch2_sensor"; tag_exterior_door = "monarch2_outer"; tag_interior_door = "monarch2_inner"},/obj/machinery/airlock_sensor{frequency = 1379; id_tag = "monarch2_sensor"; layer = 3.3; pixel_x = 12; pixel_y = -25},/turf/simulated/floor/plating,/area/adminprep/valansship)
"bg" = (/obj/structure/closet/hydrant{pixel_y = 32},/obj/item/weapon/storage/toolbox/mechanical,/obj/item/clothing/glasses/welding,/obj/item/weapon/twohanded/fireaxe,/obj/item/stack/sheet/alloy/plasteel{amount = 50},/obj/item/stack/sheet/metal{amount = 50},/obj/item/stack/sheet/glass{amount = 50},/obj/item/stack/rods{amount = 50},/turf/simulated/shuttle/floor{tag = "icon-floor7"; icon_state = "floor7"},/area/adminprep/valansship)
"bh" = (/obj/item/weapon/storage/secure/safe{pixel_x = 5; pixel_y = 29},/turf/simulated/shuttle/floor{tag = "icon-floor7"; icon_state = "floor7"},/area/adminprep/valansship)
"bi" = (/obj/machinery/bodyscanner,/obj/structure/sign/nosmoking_1{pixel_y = 32},/turf/simulated/shuttle/floor{icon_state = "floor3"},/area/adminprep/valansship)
"bj" = (/obj/machinery/body_scanconsole,/turf/simulated/shuttle/floor{icon_state = "floor3"},/area/adminprep/valansship)
"bk" = (/obj/structure/closet,/obj/item/weapon/mop,/turf/simulated/floor/plating{icon_state = "warnplate"; dir = 10},/area/adminprep/valansship)
"bl" = (/turf/simulated/floor/plating{tag = "icon-warnplate (SOUTHEAST)"; icon_state = "warnplate"; dir = 6},/area/adminprep/valansship)
"bm" = (/obj/machinery/door/blast/regular{id = "syndieshutters_telebay"; name = "Outer Airlock"},/turf/simulated/shuttle/floor{tag = "icon-floor7"; icon_state = "floor7"},/area/adminprep/valansship)
"bn" = (/obj/structure/closet/secure_closet/medical_wall{pixel_x = -32; pixel_y = 0; req_access = null; req_access_txt = "103"},/obj/item/stack/medical/splint,/obj/item/stack/medical/ointment,/obj/item/stack/medical/ointment,/obj/item/stack/medical/bruise_pack,/obj/item/stack/medical/bruise_pack,/obj/item/stack/medical/bruise_pack,/turf/simulated/shuttle/floor{icon_state = "floor3"},/area/adminprep/valansship)
"bo" = (/turf/simulated/shuttle/floor{icon_state = "floor3"},/area/adminprep/valansship)
"bp" = (/obj/structure/closet/secure_closet/medical_wall{pixel_y = 32; req_access = null; req_access_txt = "103"},/obj/item/bodybag,/obj/item/weapon/reagent_containers/syringe/antiviral,/obj/item/weapon/reagent_containers/syringe/antiviral,/obj/item/weapon/reagent_containers/syringe/antiviral,/obj/item/weapon/reagent_containers/glass/bottle/antitoxin{pixel_x = -4; pixel_y = 8},/obj/item/weapon/reagent_containers/glass/bottle/inaprovaline{pixel_x = 4; pixel_y = 7},/obj/item/weapon/reagent_containers/syringe,/turf/simulated/shuttle/floor{icon_state = "floor3"},/area/adminprep/valansship)
"bq" = (/obj/structure/sink{dir = 4; icon_state = "sink"; pixel_x = 11; pixel_y = 0},/turf/simulated/shuttle/floor{icon_state = "floor3"},/area/adminprep/valansship)
"br" = (/obj/structure/bed/chair/comfy/brown{dir = 4},/turf/simulated/shuttle/floor{tag = "icon-floor7"; icon_state = "floor7"},/area/adminprep/valansship)
"bs" = (/obj/structure/table/woodentable,/obj/item/ashtray/glass,/turf/simulated/shuttle/floor{tag = "icon-floor7"; icon_state = "floor7"},/area/adminprep/valansship)
"bt" = (/obj/structure/bed/chair/comfy/brown{dir = 8},/turf/simulated/shuttle/floor{tag = "icon-floor7"; icon_state = "floor7"},/area/adminprep/valansship)
"bu" = (/obj/machinery/door_control{desc = "A remote control-switch for the cargo bay doors."; id = "syndieshutters_telebay"; name = "Cargo Bay control"; pixel_x = 0; pixel_y = 25; req_access_txt = "103"},/turf/simulated/shuttle/floor{tag = "icon-floor7"; icon_state = "floor7"},/area/adminprep/valansship)
"bv" = (/obj/machinery/sleeper,/turf/simulated/shuttle/floor{icon_state = "floor3"},/area/adminprep/valansship)
"bw" = (/obj/structure/closet/secure_closet/medical_wall{pixel_x = 30; pixel_y = 0; req_access = null; req_access_txt = "103"},/obj/item/weapon/surgicaldrill,/obj/item/clothing/gloves/latex,/obj/item/clothing/mask/surgical,/obj/item/weapon/reagent_containers/glass/bottle/stoxin,/obj/item/weapon/reagent_containers/glass/bottle/stoxin,/obj/item/weapon/reagent_containers/syringe,/turf/simulated/shuttle/floor{icon_state = "floor3"},/area/adminprep/valansship)
"bx" = (/obj/structure/coatrack,/turf/simulated/shuttle/floor{tag = "icon-floor7"; icon_state = "floor7"},/area/adminprep/valansship)
"by" = (/obj/structure/table/woodentable,/turf/simulated/shuttle/floor{tag = "icon-floor7"; icon_state = "floor7"},/area/adminprep/valansship)
"bz" = (/obj/structure/bookcase{name = "bookcase (Reference)"},/turf/simulated/shuttle/floor{tag = "icon-floor7"; icon_state = "floor7"},/area/adminprep/valansship)
"bA" = (/turf/simulated/floor/plating{icon_state = "warnplate"; dir = 9},/area/adminprep/valansship)
"bB" = (/turf/simulated/floor/plating{dir = 1; icon_state = "warnplate"; nitrogen = 0.01; oxygen = 0.01},/area/adminprep/valansship)
"bC" = (/turf/simulated/floor/plating{icon_state = "warnplate"; dir = 5},/area/adminprep/valansship)
"bD" = (/obj/structure/table,/obj/item/roller{pixel_y = 8},/turf/simulated/shuttle/floor{icon_state = "floor3"},/area/adminprep/valansship)
"bE" = (/obj/structure/table,/obj/item/weapon/storage/surgery_bag,/turf/simulated/shuttle/floor{icon_state = "floor3"},/area/adminprep/valansship)
"bF" = (/obj/structure/shuttle/engine/heater,/obj/structure/window/reinforced{dir = 1},/turf/simulated/floor/plating/airless,/area/adminprep/valansship)
"bG" = (/turf/simulated/floor/plating,/area/adminprep/valansship)
"bH" = (/turf/simulated/floor/plating{icon_state = "warnplate"; dir = 4},/area/adminprep/valansship)
"bI" = (/obj/structure/table,/obj/item/weapon/surgicaldrill,/turf/simulated/shuttle/floor{icon_state = "floor3"},/area/adminprep/valansship)
"bJ" = (/obj/machinery/optable,/turf/simulated/shuttle/floor{icon_state = "floor3"},/area/adminprep/valansship)
"bK" = (/obj/structure/table,/obj/item/weapon/circular_saw{pixel_y = 8},/obj/item/stack/medical/advanced/bruise_pack,/obj/item/weapon/FixOVein,/turf/simulated/shuttle/floor{icon_state = "floor3"},/area/adminprep/valansship)
"bL" = (/obj/structure/shuttle/engine/propulsion,/turf/space,/area/adminprep/valansship)
"bM" = (/obj/structure/sign/securearea{name = "\improper CAUTION"; pixel_x = 32},/turf/simulated/floor/plating{icon_state = "warnplate"; dir = 4},/area/adminprep/valansship)

(1,1,1) = {"
aaabacacadaaaaaaaaaaaaaaabacacadaa
aaacaeafacaaaaaaaaaaaaaaacagahacaa
aaacaiaiacaaaaaaaaaaaaaaacajakacaa
abacalacacaaaaaaaaaaaaaaacacamacad
anaoaiapacaaaaaaaaaaaaaaacaqaiarac
asataiacacacadaaaaaaabacacacaiauac
avawaialaxayacazaAaBacaCaDalaiaEac
aFacacacaGaHacaIaiaJacaKaGacacacaL
aMaNaOaPaQaRacaSaiaTacaUaVaWaXaYaZ
aaaNbabbaibcacacalacacbdaibebfaYaa
abacacacaiaiaiaraibgbhaiaiacacacad
acbibjacalacaiaiaiaiaiacalacbkblbm
acbnbobpbqacaibrbsbtaiacaibuaiaibm
acbvbjbobwacbxbrbybtbzacbAbBbCaibm
acbDbobobEacbFbFbFbFbFacaRbGbHaibm
aFacbIbJbKacbLbLbLbLbLacaRbGbMacaL
aaaFacacacaLaaaaaaaaaaaFacacacaLaa
"}
