"a" = (/turf/simulated/floor/plating,/area/space)
"b" = (/obj/machinery/atmospherics/pipe/simple/visible{icon_state = "intact"; dir = 6},/turf/simulated/floor/plating,/area/space)
"c" = (/obj/machinery/atmospherics/pipe/simple/visible{dir = 4},/turf/simulated/floor/plating,/area/space)
"d" = (/obj/machinery/atmospherics/pipe/manifold/visible{dir = 1},/turf/simulated/floor/plating,/area/space)
"e" = (/obj/machinery/atmospherics/pipe/simple/visible{tag = "icon-intact (NORTHWEST)"; icon_state = "intact"; dir = 9},/turf/simulated/floor/plating,/area/space)
"f" = (/obj/machinery/atmospherics/pipe/simple/visible,/turf/simulated/floor/plating,/area/space)
"g" = (/obj/machinery/atmospherics/pipe/simple/visible{tag = "icon-intact (SOUTHWEST)"; icon_state = "intact"; dir = 10},/turf/simulated/floor/plating,/area/space)
"h" = (/obj/machinery/atmospherics/pipe/simple/visible{tag = "icon-intact (NORTHEAST)"; icon_state = "intact"; dir = 5},/turf/simulated/floor/plating,/area/space)

(1,1,1) = {"
aaaaaaaaaa
aaaaabccca
abccdeaaaa
afbgfaaaaa
aheffaaaaa
aaaffaaaaa
accefaaaaa
aaaaaaaaaa
aaaaaaaaaa
aaaaaaaaaa
"}
