"a" = (/turf/space,/area/space)
"b" = (/turf/simulated/shuttle/wall{icon_state = "swall_s6"; dir = 2},/area/space)
"c" = (/obj/structure/grille,/obj/structure/window/reinforced{dir = 1; maxhealth = 1.#INF},/obj/structure/window/reinforced,/obj/structure/window/reinforced{dir = 8},/turf/simulated/shuttle/floor,/area/space)
"d" = (/obj/structure/grille,/obj/structure/window/reinforced{dir = 1; maxhealth = 1.#INF},/obj/structure/window/reinforced,/obj/structure/window/reinforced{dir = 4},/turf/simulated/shuttle/floor,/area/space)
"e" = (/turf/simulated/shuttle/wall{icon_state = "swall_s10"; dir = 2},/area/space)
"f" = (/turf/simulated/shuttle/wall{icon_state = "swall3"; dir = 2},/area/space)
"g" = (/obj/machinery/computer/shuttle_control,/turf/simulated/shuttle/floor,/area/space)
"h" = (/obj/machinery/computer/security,/turf/simulated/shuttle/floor,/area/space)
"i" = (/turf/simulated/shuttle/floor,/area/space)
"j" = (/obj/structure/shuttle/window,/obj/structure/grille,/turf/space,/area/space)
"k" = (/obj/machinery/door/airlock/external,/turf/simulated/shuttle/floor,/area/space)
"l" = (/obj/structure/window/reinforced{dir = 1; maxhealth = 1.#INF},/obj/structure/shuttle/engine/heater,/turf/simulated/floor/plating,/area/space)
"m" = (/turf/simulated/shuttle/wall{icon_state = "swall_s5"; dir = 2},/area/space)
"n" = (/obj/structure/shuttle/engine/propulsion,/turf/space,/area/space)
"o" = (/turf/simulated/shuttle/wall{icon_state = "swall_s9"; dir = 2},/area/space)

(1,1,1) = {"
aaaaaaaaaa
aaabcdeaaa
aaafghfaaa
aaafiifaaa
aaajiifaaa
aaajiifaaa
aaakiifaaa
aaafllfaaa
aaamnnoaaa
aaaaaaaaaa
"}
