"aa" = (/turf/space,/area/space)
"ab" = (/turf/space,/turf/simulated/shuttle/wall{dir = 8; icon_state = "diagonalWall3"},/area/monarch)
"ac" = (/turf/simulated/shuttle/wall{icon_state = "wall3"},/area/monarch)
"ad" = (/turf/space,/turf/simulated/shuttle/wall{dir = 1; icon_state = "diagonalWall3"},/area/monarch)
"ae" = (/obj/machinery/atmospherics/pipe/tank/air,/turf/simulated/shuttle/plating,/area/monarch)
"af" = (/obj/structure/curtain/open/shower,/obj/machinery/shower{icon_state = "shower"; dir = 4},/obj/machinery/light{dir = 1},/turf/simulated/floor{icon_state = "white"},/area/monarch)
"ag" = (/obj/structure/curtain/open/shower,/obj/machinery/shower{icon_state = "shower"; dir = 8},/turf/simulated/floor{icon_state = "white"},/area/monarch)
"ah" = (/obj/machinery/atmospherics/pipe/manifold/visible{tag = "icon-map (WEST)"; icon_state = "map"; dir = 8},/turf/simulated/shuttle/plating,/area/monarch)
"ai" = (/obj/machinery/atmospherics/pipe/simple/visible{tag = "icon-intact (NORTHWEST)"; icon_state = "intact"; dir = 9},/turf/simulated/shuttle/plating,/area/monarch)
"aj" = (/obj/structure/toilet{dir = 4},/turf/simulated/floor{icon_state = "white"},/area/monarch)
"ak" = (/obj/machinery/atmospherics/unary/vent_pump/on,/turf/simulated/floor{icon_state = "white"},/area/monarch)
"al" = (/obj/machinery/door/airlock/centcom,/obj/machinery/atmospherics/pipe/simple/visible/universal,/turf/simulated/shuttle/plating,/area/monarch)
"am" = (/obj/machinery/atmospherics/pipe/simple/hidden/supply,/obj/machinery/door/airlock/centcom,/obj/machinery/atmospherics/pipe/simple/hidden/supply,/turf/simulated/floor,/area/monarch)
"an" = (/obj/structure/grille,/obj/structure/window/reinforced{dir = 1},/obj/structure/window/reinforced{dir = 4},/obj/structure/window/reinforced{dir = 8},/turf/simulated/shuttle/plating,/area/monarch)
"ao" = (/turf/simulated/shuttle/plating,/area/monarch)
"ap" = (/obj/machinery/atmospherics/pipe/manifold/hidden/supply{dir = 8},/turf/simulated/shuttle/plating,/area/monarch)
"aq" = (/obj/machinery/atmospherics/unary/vent_pump/on{dir = 8},/turf/simulated/shuttle/plating,/area/monarch)
"ar" = (/obj/structure/table,/obj/machinery/microwave,/obj/machinery/atmospherics/unary/vent_pump/on{dir = 4},/turf/simulated/shuttle/plating,/area/monarch)
"as" = (/obj/machinery/atmospherics/pipe/manifold/hidden/supply{dir = 4},/turf/simulated/shuttle/plating,/area/monarch)
"at" = (/obj/structure/bed/chair/shuttle,/turf/simulated/shuttle/plating,/area/monarch)
"au" = (/obj/structure/grille,/obj/structure/window/reinforced{dir = 4},/obj/structure/window/reinforced{dir = 8},/turf/simulated/shuttle/plating,/area/monarch)
"av" = (/obj/machinery/cryopod/right,/turf/simulated/shuttle/plating,/area/monarch)
"aw" = (/obj/machinery/light{dir = 4},/obj/machinery/atmospherics/pipe/simple/hidden/supply,/turf/simulated/shuttle/plating,/area/monarch)
"ax" = (/obj/machinery/atmospherics/pipe/simple/hidden/supply,/obj/machinery/light{dir = 8},/turf/simulated/shuttle/plating,/area/monarch)
"ay" = (/obj/structure/table,/obj/item/weapon/storage/box/donkpockets,/turf/simulated/shuttle/plating,/area/monarch)
"az" = (/obj/structure/grille,/obj/structure/window/reinforced,/obj/structure/window/reinforced{dir = 4},/obj/structure/window/reinforced{dir = 8},/turf/simulated/shuttle/plating,/area/monarch)
"aA" = (/obj/machinery/atmospherics/pipe/simple/hidden/supply{dir = 5},/turf/simulated/shuttle/plating,/area/monarch)
"aB" = (/obj/structure/cable{d1 = 4; d2 = 8; icon_state = "4-8"},/obj/machinery/door/airlock/centcom,/obj/machinery/atmospherics/pipe/simple/hidden/supply{dir = 4},/turf/simulated/shuttle/plating,/area/monarch)
"aC" = (/obj/machinery/atmospherics/pipe/simple/hidden/supply{dir = 10},/turf/simulated/shuttle/plating,/area/monarch)
"aD" = (/obj/structure/closet/crate,/obj/item/stack/sheet/mineral/phoron,/obj/item/stack/sheet/mineral/phoron,/obj/item/stack/sheet/mineral/phoron,/obj/item/stack/sheet/mineral/phoron,/obj/item/stack/sheet/mineral/phoron,/obj/item/stack/sheet/mineral/phoron,/obj/item/stack/sheet/mineral/phoron,/obj/item/stack/sheet/mineral/phoron,/turf/simulated/floor/plating{icon_state = "warnplate"; dir = 9},/area/monarch)
"aE" = (/obj/structure/grille,/obj/structure/window/reinforced,/obj/structure/window/reinforced{dir = 1},/obj/structure/window/reinforced{tag = "icon-rwindow (WEST)"; icon_state = "rwindow"; dir = 8},/turf/simulated/shuttle/plating,/area/monarch)
"aF" = (/obj/structure/grille,/obj/structure/window/reinforced,/obj/structure/window/reinforced{dir = 1},/turf/simulated/shuttle/plating,/area/monarch)
"aG" = (/obj/structure/grille,/obj/structure/window/reinforced,/obj/structure/window/reinforced{dir = 1},/obj/structure/window/reinforced{dir = 4},/turf/simulated/shuttle/plating,/area/monarch)
"aH" = (/obj/structure/table/rack,/obj/random/toolbox,/obj/random/tool,/turf/simulated/floor/plating{icon_state = "warnplate"; dir = 5},/area/monarch)
"aI" = (/obj/machinery/atmospherics/pipe/simple/hidden/supply{dir = 6},/turf/simulated/shuttle/plating,/area/monarch)
"aJ" = (/obj/machinery/door/airlock/centcom,/obj/machinery/atmospherics/pipe/simple/hidden/supply{dir = 4},/turf/simulated/shuttle/plating,/area/monarch)
"aK" = (/obj/machinery/atmospherics/pipe/simple/hidden/supply{dir = 9},/turf/simulated/shuttle/plating,/area/monarch)
"aL" = (/obj/structure/bed/chair/shuttle{tag = "icon-chair3 (NORTH)"; icon_state = "chair3"; dir = 1},/turf/simulated/shuttle/plating,/area/monarch)
"aM" = (/turf/space,/turf/simulated/shuttle/wall{icon_state = "diagonalWall3"},/area/monarch)
"aN" = (/obj/machinery/atmospherics/pipe/simple/hidden/supply,/turf/simulated/shuttle/plating,/area/monarch)
"aO" = (/obj/structure/closet/crate,/obj/item/clothing/head/collectable/beret,/turf/simulated/floor/plating{icon_state = "warnplate"; dir = 8},/area/monarch)
"aP" = (/obj/machinery/computer/shuttle,/turf/simulated/shuttle/plating,/area/monarch)
"aQ" = (/obj/machinery/computer/shuttle_control,/turf/simulated/shuttle/plating,/area/monarch)
"aR" = (/obj/structure/table/rack,/obj/random/tech_supply,/obj/random/tech_supply,/turf/simulated/floor/plating{icon_state = "warnplate"; dir = 4},/area/monarch)
"aS" = (/turf/space,/turf/simulated/shuttle/wall{dir = 4; icon_state = "diagonalWall3"},/area/monarch)
"aT" = (/obj/structure/grille,/obj/structure/window/reinforced{tag = "icon-rwindow (WEST)"; icon_state = "rwindow"; dir = 8},/obj/structure/window/reinforced{dir = 1},/obj/structure/window/reinforced,/obj/structure/window/reinforced{dir = 4},/turf/simulated/floor/plating{icon_state = "warnplate"; dir = 8},/area/monarch)
"aU" = (/obj/machinery/light{dir = 1},/obj/machinery/atmospherics/portables_connector,/obj/machinery/portable_atmospherics/canister/air/airlock,/turf/simulated/floor/plating,/area/monarch)
"aV" = (/obj/structure/grille,/obj/structure/window/reinforced{tag = "icon-rwindow (WEST)"; icon_state = "rwindow"; dir = 8},/obj/structure/window/reinforced{dir = 1},/obj/structure/window/reinforced,/obj/structure/window/reinforced{dir = 4},/turf/simulated/floor/plating{icon_state = "warnplate"; dir = 4},/area/monarch)
"aW" = (/obj/structure/ore_box,/obj/machinery/light{dir = 4; icon_state = "tube1"},/turf/simulated/floor/plating{icon_state = "warnplate"; dir = 8},/area/monarch)
"aX" = (/obj/structure/bed/chair/shuttle{tag = "icon-chair3 (NORTH)"; icon_state = "chair3"; dir = 1},/obj/machinery/light,/turf/simulated/shuttle/plating,/area/monarch)
"aY" = (/obj/machinery/atmospherics/unary/vent_pump/on,/turf/simulated/shuttle/plating,/area/monarch)
"aZ" = (/obj/structure/closet/crate/medical,/obj/machinery/light{dir = 8; icon_state = "tube1"; pixel_y = 0},/obj/item/weapon/storage/firstaid,/obj/item/weapon/storage/firstaid/adv,/obj/item/weapon/storage/firstaid/fire,/obj/item/weapon/storage/firstaid/o2,/obj/item/weapon/storage/firstaid/toxin,/turf/simulated/floor/plating{icon_state = "warnplate"; dir = 4},/area/monarch)
"ba" = (/obj/machinery/access_button{command = "cycle_exterior"; frequency = 1379; layer = 3.3; master_tag = "monarch1_airlock"; name = "exterior access button"; pixel_x = 25; pixel_y = 25; req_access_txt = "0"},/turf/space,/area/space)
"bb" = (/obj/machinery/door/airlock/external{frequency = 1379; icon_state = "door_locked"; id_tag = "mornarch1_outer"; locked = 1; name = "External Airlock"; req_access = null; req_access_txt = "0"},/turf/simulated/floor/plating{icon_state = "warnplate"; dir = 8},/area/monarch)
"bc" = (/obj/machinery/atmospherics/unary/vent_pump/high_volume{dir = 1; frequency = 1379; id_tag = "monarch1_pump"},/obj/machinery/embedded_controller/radio/airlock/airlock_controller{frequency = 1379; id_tag = "monarch1_airlock"; layer = 3.3; pixel_x = 0; pixel_y = -25; req_access_txt = "0"; tag_airpump = "monarch1_pump"; tag_chamber_sensor = "monarch1_sensor"; tag_exterior_door = "monarch1_outer"; tag_interior_door = "monarch1_inner"},/obj/machinery/airlock_sensor{frequency = 1379; id_tag = "monarch1_sensor"; layer = 3.3; pixel_x = 12; pixel_y = -25},/turf/simulated/floor/plating,/area/monarch)
"bd" = (/obj/machinery/door/airlock/external{frequency = 1379; icon_state = "door_locked"; id_tag = "mornarch1_inner"; locked = 1; name = "External Airlock"; req_access = null; req_access_txt = "0"},/turf/simulated/floor/plating{icon_state = "warnplate"; dir = 4},/area/monarch)
"be" = (/obj/machinery/atmospherics/pipe/simple/hidden/supply,/obj/machinery/access_button{command = "cycle_interior"; frequency = 1379; layer = 3.3; master_tag = "monarch1_airlock"; name = "interior access button"; pixel_x = -25; pixel_y = 25; req_access_txt = "13"},/turf/simulated/shuttle/plating,/area/monarch)
"bf" = (/obj/structure/closet,/turf/simulated/floor/plating{icon_state = "warnplate"; dir = 10},/area/monarch)
"bg" = (/obj/machinery/door/airlock/centcom,/obj/machinery/atmospherics/pipe/simple/hidden/supply,/obj/structure/cable{d1 = 1; d2 = 2; icon_state = "1-2"},/obj/machinery/atmospherics/pipe/simple/hidden/supply,/turf/simulated/shuttle/plating,/area/monarch)
"bh" = (/obj/structure/closet,/turf/simulated/floor/plating{icon_state = "warnplate"; dir = 6},/area/monarch)
"bi" = (/obj/machinery/atmospherics/pipe/simple/hidden/supply,/obj/machinery/access_button{command = "cycle_interior"; frequency = 1379; layer = 3.3; master_tag = "monarch2_airlock"; name = "interior access button"; pixel_x = 25; pixel_y = 25; req_access_txt = "13"},/turf/simulated/shuttle/plating,/area/monarch)
"bj" = (/obj/machinery/door/airlock/external{frequency = 1379; icon_state = "door_locked"; id_tag = "mornarch2_inner"; locked = 1; name = "External Airlock"; req_access = null; req_access_txt = "0"},/turf/simulated/floor/plating{icon_state = "warnplate"; dir = 8},/area/monarch)
"bk" = (/obj/machinery/atmospherics/unary/vent_pump/high_volume{dir = 1; frequency = 1379; id_tag = "monarch2_pump"},/obj/machinery/embedded_controller/radio/airlock/airlock_controller{frequency = 1379; id_tag = "monarch2_airlock"; layer = 3.3; pixel_x = 0; pixel_y = -25; req_access_txt = "0"; tag_airpump = "monarch2_pump"; tag_chamber_sensor = "monarch2_sensor"; tag_exterior_door = "monarch2_outer"; tag_interior_door = "monarch2_inner"},/obj/machinery/airlock_sensor{frequency = 1379; id_tag = "monarch2_sensor"; layer = 3.3; pixel_x = 12; pixel_y = -25},/turf/simulated/floor/plating,/area/monarch)
"bl" = (/obj/machinery/door/airlock/external{frequency = 1379; icon_state = "door_locked"; id_tag = "mornarch2_outer"; locked = 1; name = "External Airlock"; req_access = null; req_access_txt = "0"},/turf/simulated/floor/plating{icon_state = "warnplate"; dir = 4},/area/monarch)
"bm" = (/obj/machinery/access_button{command = "cycle_exterior"; frequency = 1379; layer = 3.3; master_tag = "monarch2_airlock"; name = "exterior access button"; pixel_x = -25; pixel_y = 25; req_access_txt = "0"},/turf/space,/area/space)
"bn" = (/obj/machinery/atmospherics/pipe/simple/hidden/supply{dir = 4; icon_state = "intact-supply"; tag = "icon-intact (EAST)"},/turf/simulated/shuttle/plating,/area/monarch)
"bo" = (/obj/machinery/light{dir = 1},/obj/machinery/atmospherics/pipe/simple/hidden/supply{dir = 4; icon_state = "intact-supply"; tag = "icon-intact (EAST)"},/turf/simulated/shuttle/plating,/area/monarch)
"bp" = (/obj/machinery/atmospherics/pipe/manifold4w/hidden/supply,/turf/simulated/shuttle/plating,/area/monarch)
"bq" = (/obj/machinery/optable,/turf/simulated/floor{icon_state = "white"},/area/monarch)
"br" = (/obj/machinery/computer/operating,/turf/simulated/floor{icon_state = "white"},/area/monarch)
"bs" = (/obj/machinery/door/airlock/centcom,/obj/machinery/atmospherics/pipe/simple/hidden/supply,/turf/simulated/shuttle/plating,/area/monarch)
"bt" = (/obj/machinery/atmospherics/unary/vent_pump/on{dir = 1},/turf/simulated/shuttle/plating,/area/monarch)
"bu" = (/obj/structure/table,/obj/item/seeds/random,/obj/item/seeds/random,/obj/item/seeds/random,/obj/item/weapon/hatchet,/obj/item/weapon/minihoe,/obj/item/weapon/shovel/spade,/turf/simulated/floor{icon_state = "dark"},/area/monarch)
"bv" = (/obj/structure/closet/secure_closet/freezer/meat,/turf/simulated/floor{icon_state = "dark"},/area/monarch)
"bw" = (/turf/simulated/floor{icon_state = "white"},/area/monarch)
"bx" = (/obj/structure/table,/obj/machinery/light{tag = "icon-tube1 (NORTH)"; icon_state = "tube1"; dir = 1},/obj/item/weapon/storage/surgery_bag,/turf/simulated/floor{icon_state = "white"},/area/monarch)
"by" = (/obj/machinery/atmospherics/pipe/simple/hidden/supply,/turf/simulated/floor{icon_state = "white"},/area/monarch)
"bz" = (/obj/structure/shuttle/engine/heater,/turf/simulated/shuttle/wall{icon_state = "wall3"},/area/monarch)
"bA" = (/obj/machinery/atmospherics/pipe/simple/hidden/supply,/turf/simulated/floor{icon_state = "dark"},/area/monarch)
"bB" = (/obj/machinery/light{tag = "icon-tube1 (NORTH)"; icon_state = "tube1"; dir = 1},/obj/machinery/seed_extractor,/turf/simulated/floor{icon_state = "dark"},/area/monarch)
"bC" = (/turf/simulated/floor{icon_state = "dark"},/area/monarch)
"bD" = (/obj/item/weapon/storage/firstaid,/obj/structure/table,/turf/simulated/floor{icon_state = "white"},/area/monarch)
"bE" = (/obj/machinery/atmospherics/unary/vent_pump/on{dir = 1},/turf/simulated/floor{icon_state = "white"},/area/monarch)
"bF" = (/obj/structure/shuttle/engine/propulsion,/turf/space,/area/monarch)
"bG" = (/obj/machinery/atmospherics/unary/vent_pump/on{dir = 1},/turf/simulated/floor{icon_state = "dark"},/area/monarch)
"bH" = (/obj/structure/reagent_dispensers/watertank,/obj/item/weapon/reagent_containers/glass/bucket,/turf/simulated/floor{icon_state = "dark"},/area/monarch)
"bI" = (/obj/machinery/sleeper{icon_state = "sleeper_0-r"; orient = "RIGHT"},/turf/simulated/floor{icon_state = "white"},/area/monarch)
"bJ" = (/obj/machinery/sleep_console,/turf/simulated/floor{icon_state = "white"},/area/monarch)
"bK" = (/obj/machinery/vending/hydronutrients,/obj/machinery/light,/turf/simulated/floor{icon_state = "dark"},/area/monarch)
"bL" = (/obj/machinery/portable_atmospherics/hydroponics,/obj/machinery/light,/turf/simulated/floor{icon_state = "dark"},/area/monarch)
"bM" = (/obj/structure/grille,/obj/structure/window/reinforced{dir = 1},/obj/structure/window/reinforced,/obj/structure/window/reinforced{dir = 8},/turf/simulated/shuttle/plating,/area/monarch)
"bN" = (/obj/structure/grille,/obj/structure/window/reinforced{dir = 1},/obj/structure/window/reinforced,/turf/simulated/shuttle/plating,/area/monarch)
"bO" = (/obj/structure/grille,/obj/structure/window/reinforced{dir = 1},/obj/structure/window/reinforced,/obj/structure/window/reinforced{dir = 4},/turf/simulated/shuttle/plating,/area/monarch)

(1,1,1) = {"
aaabacacadaaaaaaaaaaaaaaabacacadaa
aaacaeaeacaaaaaaaaaaaaaaacafagacaa
aaacahaiacaaaaaaaaaaaaaaacajakacaa
abacalacacaaaaaaaaaaaaaaacacamacad
anaoapaqacaaaaaaaaaaaaaaacarasatac
auavawacacacadaaaaaaabacacacaxayac
azavaAaBaCaDacaEaFaGacaHaIaJaKaLac
aMacacacaNaOacaPaoaQacaRaNacacacaS
aaaTaUaVaNaWacaXaYaLacaZaNaTaUaVaa
babbbcbdbebfacacbgacacbhbibjbkblbm
abacacacapbnbnbobpbnbnbnasacacacad
acbqbracbsacaoaobtaoaoacbsacbubvac
acbwbwbxbyacbzbzacbzbzacbAbBbCbCac
acbDbwbwbEacbFbFaabFbFacbGbCbCbHac
aMacbIbJbwacaaaaaaaaaaacbKbLbLacaS
aaaMbMbNbOaSaaaaaaaaaaaMbMbNbOaSaa
"}
